rewards_rank,rank,index,adjusted_balance,block_proposals,beta_epochs_missed,balance,start_balance,eth1_addr,pub
1,1,123344,469650242,3,0,32475872500,32006222258,0x95a286070f6d80761e58a84297c532621c18a725,0xac6a6450dce343155bdd365055c3264147d516f8c86bbba95163a6d75b3bfa447047fddfc095e67e4ef484c804705b07
2,2,123928,363681595,12,0,32365290008,32001608413,0x0f16ad3e18a24de047defb8d5c5fead4ff1c3879,0xa9372a5d4b2a3d254267b2653c12960fe62210eeaff8b5f8ddf4673613a4f3d9d9516f35af9c93d06eaa443865de36b2
3,3,123924,357010567,9,0,32358560276,32001549709,0xccff99c4bcf4129ba65b0b464bcc82d59eb003bc,0xa2e2fcbdd97d37a8f9318300fdef363727891da44f012a6ac8172b660b68cb015c9a50bb9eacd47123d6035921bbb6d7
4,4,123363,354381690,8,0,32360604212,32006222522,0x3fbccb0def24f07bb5c5d3391c9bf775e0578a4f,0x93315f26c44b55ba63d27bfed727883c70e6870c975baa9270dc3fb0c50191f27fad5b8ada8644f9e1cfaba2c7e76820
5,5,124000,346459628,4,41,32346459628,32000000000,0x3b52091cb78e25e6f399b300cdb7cced4323ba0a,0x85711d6d6da73dd5e2d89ab93a4474e071686dae7347258bb4fdf1bd2b298dcb94795417f0ee697f6107b15de302b21f
6,6,123104,341909801,6,0,32349518161,32007608360,0x34543ee4c5815c9b588e88adc09331b8bd075407,0xa26311e1d40e2f0365bdf033396a80cba858abd2ad0f5a4ae5b1f5568516a4ca095dc6c1644c7548a4b77fbd1074057b
7,7,123484,306434628,9,0,32312097238,32005662610,0x384757b82e2780be200df828daa9beab18ca3d41,0xa2b089e2e6b4fed39eb097d681b686e0eca929d94fa933b509dc0712d3fe87a5c0eabc9a1066d0262a20d71ffa99d90a
8,8,123053,296546177,8,0,32300630988,32004084811,0x0c02d5c64f40fcfe10bf65ee900598b6bf9f8ded,0xa7350a558c63bb00d34f188d4ef69fac8fabd710eaa4652878159312ce86e05f6f94f6b2d2fc7a9acb8eb8193d7c13fe
9,9,123465,294654161,8,0,32300361333,32005707172,0x59ff430222fd3fd428a001fad3d7b1fc5c0b0e24,0x89719e81c9aaadf05a7b348e8405d9212aa9f15508a15ed3a3e26caa8532dbbc584abe312564dafd258d07388f05098a
10,10,123843,291167488,4,0,32293321497,32002154009,0x73cf13dbf6526a6147a55de43d054ec2ac32ff52,0x87e14daced617f2748b372f755936b2445e899a2852399217aa2c3c900d4e00eea7014a832323a37f288836bd5a5103b
11,11,123833,288591682,5,0,32290800175,32002208493,0x76c85df39405937be6fe8ac1e44b3ef4ac2b631a,0x93641a58e0b77f2c7871954f936b42faa8f32803be10030b34cc2deaf6e98c5f7dc31bfb53eef86cd220f045be036264
12,12,123563,288565430,3,0,32296916850,32008351420,0x68ab3ef8d21d20e99282f616c5df54102720a023,0xb756a958c1b781b367f7f4d38c44b6f5194f98074d074936ccca6b7a516485f6070bdad0698057c5ddac2579b70f25fd
13,13,123802,286327974,3,0,32288751228,32002423254,0x9ac6ff47ea5a6a30be211ccbb4b8c488f74de778,0x882749070a2b60fd08b5156268fccf9f0d7c4bc82781e10f02b5ee2e02c4b289a2b626e1310612616ddb182b61058d91
14,14,123494,286055255,3,0,32291640192,32005584937,0x34a708f8f8f2aca1a92509beceb22e5f028e1462,0x83f9cf6d5925dd70c7fd333e01f2cc57c440fa1ed40eccab157989af762bb2d71f9b2c773df4dbfa7a0293a81632c822
15,15,123230,285219258,3,0,32292047078,32006827820,0xd5368ae7e579d6f589b6f59ca12e335a6dfb0001,0xa77b213084283760713e5fb831b129385f972dd60e3e2b8395913898955bfc7cb96c3b5daabe58444ae276d613c33b18
16,16,123566,282981650,3,0,32291334344,32008352694,0x754e40ba838ca7925f78b0fb46a399eaf1c6b982,0x8b4eee5f65598f2b99efce2396e330048841b6542260d103879a8dc857578c976fc72808905a4f58fe00081eb9c60130
17,17,123932,280072635,1,0,32281649563,32001576928,0x7d155c66a91f8ee57845ed33641bedbe59ba391d,0xa59ce692c1f33b86b62d2076faa8c023715f2704a57233d5c77f7197dd6bae94a24348801e506523343733275951cda2
18,18,121592,278786917,4,0,32308275939,32029489022,0x68498b5bca2049133141e4e9583114b8f0b0189b,0x8d1e10a26eebf734bf10d69eb6180b2aa19c51704fdeb7dfe316c3cb184b9d21a51750c381674931cf875ec5e95a1a5a
19,19,123105,278115514,11,0,32285735753,32007620239,0x76ecb9a5e88a52c11fb5c6d005de2a4af717fcca,0xa190dc87743d6aa333b673e567f18caa431355529bc161e6926c5656e757e0fa3aadc83835783429635c3ba8eb23de18
20,20,121563,277956459,1,0,32324088922,32046132463,0xb4c6b0bbb950be7d08fe577915c9d40df43557be,0xa9d1c148fcbaf75c5e1f52ea95dafa2d26da9fae57663d88cfd1d0c06b4044e77fa12a766eac234b19b50a1197d916f9
21,21,124058,276333720,5,167,32276333720,32000000000,0x6c4cbd214bdc9f0905bfb29eb1d9bfba58348972,0xb96b8aa13b6218cd8609fd64de548549c50cb8d98bdfafdcff9ff5778317975a2f77ed7c0af2bf33e0a76e26faf5533d
22,22,123808,272039440,1,0,32274367188,32002327748,0x8a5a986d11dfd812c88b8f131bbafe306b478969,0x951f559e747f2dc9cf2148e50f3acb198c69d2a465dc90f11c876131b2d6836c9b3bfd895c85b1ca75c65fb97c389a55
23,23,123383,245232992,9,0,32251316572,32006083580,0x8b667c6dd17df4614a9777298b2f95518673ad4d,0xadd22870c7731e7a4b900374c0128576313a18ae3d46252e1a062c178f13a9babba3736542309fe090d67d0181002841
24,24,123455,241812674,7,0,32247599242,32005786568,0x7e78228ecad2b14bec742af5507f102116d23e87,0xa07024df774d3ed5e8ce2d4ec0e05907b624204efbe3212cd7c3d2dec6ee0afdf9dfe5d0abb3337d3a1ea9615e55f8ea
25,25,123560,240880976,14,0,32246050011,32005169035,0xbdc3b1550be3db6197627b637da2e2f7b2f198f4,0xb904f3bef723a63a2717994e5fe3655ff2730df9a659aa566957add0f09c32b9f9cd5b0d600e91815363505a4e04ede1
26,26,123945,240654105,10,0,32242126031,32001471926,0x2677761b0edf2019029f580431a5f0d76dab5058,0xb901e8c0e379b61df80dfd37f7ca35d98e80413da8eb5bf288d4a4ae8075f1e639d688cabac92f0bb83681e054ff3640
27,27,123042,238136570,6,0,32246162741,32008026171,0xdab42e4ecb6744fbb854248746c1ca81c4df289e,0xb24c98d383531128a801a3fa7c96d0f13a51c26192cde3b6d7fe5ccfb4c386e3c32a62c0893178a85050dc856b10d192
28,28,123322,237421964,11,0,32246964411,32009542447,0xf2667438a7bcec847ac58c4ca6fcfc68c152cad0,0xaa3687502e33330da2cac12f22f37226c2e1ee059121b9d632cada436010f29addf7e0ef2caa593f87579e2a58ac1e0a
29,29,123551,237171092,6,0,32242473277,32005302185,0x1bd461fbc9559a689803cd8374a054c3a041c7d0,0x8dc0f1541cc226a2fa679d8f6981ee66ff702f98c441efef4761a17312780e5ff561c29e316188eee5392257b26b5467
30,30,123384,236816814,5,0,32251091299,32014274485,0x57e7fc26ac6a3d7daa72242243dfcdb3c910c5fb,0x8c7add41a14e5467ba1af40d33398e71c089e50ce56ed400141eab4a54647a35e8067e1df422347b676af86bbd0d7406
31,31,123627,236038713,11,0,32244490014,32008451301,0x70b4e030b2ffbc1c44c7ee1bee17b26d34b167a3,0x99e9e05aaa057cdefc850443c7d04a02c1e095551d005328085e5b6a5b7b86a8c543da6e4c3c9ff537955efb3f234195
32,32,123086,235611680,8,0,32243249031,32007637351,0x3ac904cb96e1cef6a10762b5e82fdbb60696b0ec,0x884376c896da9ae004875766e2bdd7e656badd2fcb3c9cccac2fca77b7cfd0a50effacdabbb67c191efe119101fee796
33,33,123361,235520117,9,0,32241741553,32006221436,0x6501969cd31b4a44aedf2c35793e6d1f5d8b3d45,0xb07c81757b85568536683b80792a1312b0df74880adbcdc097e482ae70ecedd98de06f43e15c9f3179e460c15f8dcfe8
34,34,123285,235448947,6,0,32239197618,32003748671,0xd20db470d6fb6f31c7d8cb7f68f31bc9883a907a,0xb35d49c133fb1058e4d2dbab5469927139a3cdd9d87fa62ba629a0636bf74c8217e8a904d0a67217d4a20b2f042d6064
,35,123557,235069786,7,0,32243368290,32008298504,0x1bd461fbc9559a689803cd8374a054c3a041c7d0,0xb3ba9a794933777a1bfa924185dbf12546e3fc8d628b5f94c766d118277541aa47c0e9b3234bf0b4f5afe3fd8b47a8ec
35,36,123489,234894539,10,0,32240434983,32005540444,0x675152957f05e44f52de58186817defb693dcd66,0xadeca417ecf59d72e3269829e85f2fd480c909414db5a6531107569dec0ac9107a94283236393542c8b61e5b593f6b2b
36,37,123314,234690126,9,0,32241065041,32006374915,0x7f3449e2609fbca83423039a955b5213702a8ce6,0x8a790f7f4b184b22305ce32ff241aee43e90014de6e361f7810d5ca5199e6970f78e7207e3288485306e6c191e93eed7
37,38,123351,234644307,6,0,32240976574,32006332267,0x0be332a7a67561785872f0c602bdc991d0331ccc,0xa573f6bef657f26de59f6ba0e6e25c7bfa7712ab655aba9d54567d007bd7e11a68038c527aef453eebe424daa84a34d1
38,39,123293,234225259,7,0,32240718035,32006492776,0xf8d03584c30d2a9036c58e2bd3079f4bef98456f,0xb678c40511d03b56b33baf882676cd924aa1480c17e88fd02a9ffd7cc00930ee0fb7ed6bba519327d250c6667ed80f7a
,40,123459,233778903,8,0,32239565648,32005786745,0x7e78228ecad2b14bec742af5507f102116d23e87,0xb0c5af65b9c6f768bbf74471eb28e9b4de321d96033c32d7010d451ba666c79b2057047032a988ace496d2252133ccba
39,41,123596,233172647,7,0,32238146343,32004973696,0xd529691c50719856b8b1c5f3d6b4af01afa4c958,0x86f4ff54a95e005dbace1425fe8bb9c5159fd4a3df6ac27cb9374492e541f8fa71ce52aeb54a5c0e04b92243814e6cab
40,42,123488,233099700,5,0,32238729428,32005629728,0x836504e4fc62e61ff4a53b98c4ca985d76a9800f,0x962ce4f0dff879b1f92afb25c3c15b099174131308d5037b467791378e07e7a471a3ffde46c273102e9caa03af5da66b
,43,123929,232999092,8,0,32234575332,32001576240,0x0f16ad3e18a24de047defb8d5c5fead4ff1c3879,0xa10c5c65d8fc75af3450a35703fcfa5c6c6e7751fe09d3381f1ffdbaeb82bdf8cfaa48d6ce0b94a36f6bfda9d458ac5e
41,44,123472,232805232,4,0,32238330099,32005524867,0x3d326bac04b67cd9f12ca40035bd2a770417e572,0x92bb000c94dc3d08249a191aa71d10d0eb52c10e045e5ad53bb8dfb981a3c567367af0c81da251c0c3f4a323f68f4dc2
42,45,123695,232719199,7,0,32234769192,32002049993,0xdfe34069619fb73ddf7b1541357a94abd0c8ede9,0xaec36189f444c1df630c0c821a7582c9619a421da1d771a0886e655aa77b75ceee526f77350a4c8e14e1224ab1f9d7f7
43,46,123533,232717741,5,0,32238143388,32005425647,0xa627aa20485342ca16960fd1f77c547801f7f763,0xa30f03ae5e900a68bdf2938bde80e606aab9edf10024bacab4564aa7fe1690851c51251f4b8ec7bf6bf5bf2aa4508784
44,47,123858,232660104,7,0,32234755745,32002095641,0x4ade5515303d36758b41540334410301f9e4b4b6,0x8423f9f392063308d831acbb7ec7266093b8f1bca4968ed1de2dd4641b770a18d0479a6560c49899f8e349ddb30dee27
45,48,123799,232270471,10,0,32234716090,32002445619,0x2c8bb4f561597b47f0e2e53cbe45192fe953ddcb,0x8432ab8468dd7c3710cc156aaaa68e219921f9dad0bc803fcecbd43f21a931ece2b78e766eb15a8ed90dfeb0f8d75169
46,49,123900,232035409,6,0,32233796805,32001761396,0x7fbed642b42830104533b6851be1b010ff8dbe96,0xab09abfbd3d7ef40ceb29b118d7d3e94a332cd4d3b26139a0688244ad66061363c039ba29a88748683972cacbc518e61
47,50,123223,231824093,6,0,32238664029,32006839936,0x77e88c6b9c638c087944752927ec5a5b5dc564da,0xac752833736a3c5d24049ac2f3a333b54eedfb43f3f95a2092b614cdd8dcef4b1bd3d05e5468fc2205a553ccac3621a7
48,51,123767,231734007,7,0,32235731090,32003997083,0xbcc4fa11c813eb6654aad7782c07086c6d40ba18,0xaf35bf1d2cab6a6ab0cc2175ae6e54274c0c27fad80ed184898cef8b960ba242baaf9a69bf07885590912543f81eb9a4
49,52,123441,231626268,5,0,32230907828,31999281560,0x4006cb341763c02b716b65dee5eeb79728304bbb,0xa6c2f50d270e37910e3fafe1c8f55e15569f9b7b26fec18bda2f35129c6c0db4e2ef7303da512be94b9ed4e05420ddb8
50,53,123759,231553746,9,0,32235636634,32004082888,0x9f2129b00a76bdfd5c08f20f099fb7868a01511b,0xb6dff5506e9f0a2c5e712581e99f6cd967a7dee8c13a19ae5877fd793eb95c8c44840429c612f3cc4aeb55aa39a7845a
51,54,123236,231552913,7,0,32244063606,32012510693,0x6839a80a8f8b4f098f36599ab1eb794a31044a10,0xaf3adc7c7448b1d5e28cdf6d8c45fc9b1c8a42fef660e4952aea8b8577f8ce8660a9168af711ef5a8c7ab90c059b50ed
52,55,123587,231525953,6,0,32236653884,32005127931,0x733a683d1fe5e147da514d49aa25eb285683af5d,0xb2e5a3b6cef6e5bccf63a58f4f242e7fe9b848545b15e14a96e17b801b65a4f5839f8f77982114aad97860cba3b45a49
53,56,123658,231280016,5,0,32235914193,32004634177,0xf568262449a9405b9d7cd223d3a56db9b534be38,0x938cdffdd99f0ac0fb0b8a9c9d3d045857110456ca36e348fdcf49715a709d8a8b38807e1b2e9de78fce5f60a3cd7a5c
54,57,123976,231239225,5,35,32231239225,32000000000,0x91addc72b2f6ec5fb33948a279d39b63b135bc0e,0xa52f2bd24d3ca023f3bb187e2790c6ee803fde51b243dec6fe426f63836d9dcd58da828dde1a1b633ec592a94ec65cef
55,58,123219,231200514,7,0,32238130777,32006930263,0x3049cca578cce897b37c12ba26f149654c27cc31,0xb282be4fee995bcb3dcf27d2fc244e16ed3937637cf2cdbb71cebbbf2f57a1051d3d18146508d65ef6fd3ac2ca546343
56,59,123060,231131184,5,0,32238987072,32007855888,0x9af8c16a29af0b8a7caf139b1e5e14c387579742,0xa8e7f4829ff479baf77d1d1b4206d45cd85fcafbffcda823309e591a7474d9fa2306af59c45a7964ea19fc4150663fe0
57,60,123493,230973615,6,0,32236466571,32005492956,0x58020046d1dfeb7172709be7b24aed84b2c1d788,0x95f6805d46e15109483512320b3c14a837cb3d45db3f37aef1e670af68d1bdc73fd9d6119cac6122a6b0877b4ff0483e
58,61,123500,230929522,4,0,32236421418,32005491896,0x79fd4f7ca658d4f00781401d6ec3ca8c4c2022cb,0x960a2f4a4f84bf1b1ad1dbd65260e51628f2e18dcf996078cd3244731f868b101565bb2194c64453573e2fcb1bd6c056
59,62,123782,230905579,3,0,32234754741,32003849162,0xadffcbbab807cb7e04331fe65c2d7486caed8025,0xa4abff60367e6b06922707651d693da7ca7d42b3975c944418860371c2498cf3f7ee20e54b28edc7e8f054ca38950c7c
60,63,123364,230510960,8,0,32236777972,32006267012,0x857646e21dd61f3f92cd95a34841ee3d81bb7098,0x826dd4a69dd83b6a01a743f7a85b6db2f97f87eabc577d35c2e68351ef87605d46eb8cfaf1ca060a440b355d033a0b7e
61,64,123977,230475702,5,36,32230475702,32000000000,0x3f24876db2d2a8ede45de2cf542ca14bf8ba0c10,0x8fe5941d3c3b704c50d10cb8c4962ba980bb833c8bcaf4468ae37499fbb95bc6b150b8a9c049592223fc154d586d73b3
62,65,123481,230453072,6,0,32235865533,32005412461,0x2d06ad28c0306a316e25bd13d9c9ec2d793d8eda,0x88d11e7695d9bf20ced6fe1b3e0704903a3c8d7eb52d83d758d51964073d907755d89b85c56f59cd544e84452c7c0414
63,66,124688,230374541,5,2089,32230374541,32000000000,0xc2d56d0410eeb2ff025ef89bce3f5171d6332ddc,0x8744d26e80a12896e8147e6947bdfc543818e3d94f560351a49e16731d570d2355e661d3aa56381522d411c3e201a77e
64,67,123564,230298096,6,0,32235491769,32005193673,0xb8db2748674511b86c05467909f46318b4e16f7b,0x840ea8d220d226f49fb1c293a7b68fa0578afb76ecaf13d9958364445859654028df3909b4e19fee669d79a2dae2c04a
,68,123835,230249706,5,0,32232514237,32002264531,0x2677761b0edf2019029f580431a5f0d76dab5058,0xa6aeb61095180d456c52767ba9eef10700cfca8e25510816b70bd639689aa9653fbe6808769be2e65df1a9d489a37d72
65,69,123487,230180379,5,0,32235793020,32005612641,0x6dc8ac691e3bac07bd9518e65baa110a8d405969,0xabc5b2271409f8dfb182ac56e58def9f2c59f9c2fafcb509484cc292c80c14f4a0596e8fbde13b8fbc084672c6c64016
,70,123382,230041363,6,0,32236231743,32006190380,0x8b667c6dd17df4614a9777298b2f95518673ad4d,0x895ea691857af7849b982b4f03e8f947bf1dbeb8a17facfb65a15730dc96dda485e49da7f0a417bab24de8bdf89ae03c
66,71,123565,229981632,4,0,32235075492,32005093860,0x6033ef3c85aa8d095bb856527120d6caf5a9c5af,0xb768eaf018ba03e79de74f1c0da0bc60000792acd28609ed981d1c8d3efee4c9d3c38ec6847e273708ccc90b41ca1324
67,72,123054,229955779,6,0,32242908640,32012952861,0x6993aff5aadf101de3ca2076b8ca19d8784ec9ce,0x81f00c04979105fa324ad9b4e10b74e57e4685bb41982f9d414071016a03801d44427884998ab1a57914e0c576a83944
68,73,123549,229727132,7,0,32234851785,32005124653,0xa05f233eccdcb068bfe7cac35200aac0fae3bff0,0x90926a103341c78295ee9db4010a510ffead51e2f4a58aa361578402a943826d36ef255cea4b9b1a06040fc611d43e10
69,74,123541,229591456,7,0,32227834721,31998243265,0xd6f64a53ebdf4d35a5aa824adfc08aa6ec4970a5,0x86c140ffba0681da09da4bbe84611bfdc548ca7d71edec60a319b8f61cf7ba95ad8d51af5e81c3fb1921c7385c4f7670
70,75,123662,229475651,5,0,32234073006,32004597355,0xf8ced29d9fe13ae851c31b298aec88eba0d89ede,0x901d47a0af88522f0d4253d100e77494b693f1ec50b52c76bd01d42e91a5cf742e704f65421695b9c4be497bc8847434
71,76,123613,229440212,4,0,32234399557,32004959345,0xa4f04a485f8560aa012beab69268a671c7592b94,0xa946a7d7b797ec2cb2fafb2c675159331f28a60d60ecc3145e3c635d59eae25e2766392d8ac8e0216a79174bb49d9d4b
72,77,123088,229336198,4,0,32237064687,32007728489,0x54d00e358085df08e664a009b37c6a13a36b26c2,0xa9ae5dc288c84e19b67d21b7f9f1ff23d2e4af986abe0afd4cdaf279f09d020e702553d6888a2beff77fba8e9d2cf238
73,78,123232,229319955,5,0,32236142497,32006822542,0x7732267110d7c852ccf1756e33228c9185f122cd,0xa02b9fc319db8093764a30a7bf94b4857682271f22f867e9d6827d4103c7d71646f9ec4961eee61e49b45e8b32d5277f
74,79,123701,229246895,5,0,32233643750,32004396855,0x20751a65f848c1f308facc537777e6aa2d38bcf7,0xaeb802be27b9ed10d89dad1ea16900f25eb5e556b8228ee43d973491af594cff0e8762611b737da1136fa3a571549db5
75,80,123374,229221270,7,0,32235530815,32006309545,0x950e7d48cd02b068cbb5719c7de9c252d4b1c6c9,0xa8cd5e6ea8aaa7a1258fac6c28d0f64142f0c1e9134e7897751b1fce8437dc9a2532e624f2264ad0ea1f10cd008951f9
76,81,123113,229169222,7,0,32236685371,32007516149,0xd9b003148027bf7e1729448931a92f3e9e8edbf2,0xb3a406b55da7c149778ac94dd2a7235839d15484cafda1c4d48dc1f26eda1db1c1f1d1633b33dabf98925a654f1a090c
77,82,123661,229157275,5,0,32233803086,32004645811,0x08af585321f23e7bd8f617586fc9a6a1212a2e4b,0xb8eb6854971c231380c9e154e7f1914b1361ba0bb52846604d19dd01d872e3b19a204c7456392b5e2e06a57739583793
78,83,123861,229127920,5,0,32231192483,32002064563,0x866de382f837e7f3b4a42440ce1a396a88407c46,0x9301dc5ac77696874d1005fed2c5d640fb6d80988fbb13cb1f00b5b5f116fc7ace2c7dbfdfc327a484f7d065474418f3
79,84,124137,228948602,8,357,32228948602,32000000000,0xa09aacaf98ba261026d83f5c47d6ec543f128280,0x8d9f8e5dfb8a3c35a9adc348d4d59a387f4f2032052eaf6d87e2fbadb87f6c00a4868307ead433f2690c5b08e3cb84bc
80,85,123529,228823565,4,0,32234114663,32005291098,0xd8f9b6bae3a9140be9ee4aaf099e3b3c6993b2c9,0xaf51095644849dd396971cb8634fd50975a620ec9fc9c608d5599b7d0d4e5ae3f270e1b5dea7adc520c148900c6a4f94
81,86,124097,228807601,4,228,32228807601,32000000000,0x0cdd8368c02b465945af76d3e47ee7d48caeca4d,0xacfcf128879147cf91befda425619c040e0af9f9fe1a9a78c563926192d95744431ae80e869be077344eca5e455a4e47
82,87,123081,228740120,4,0,32236461965,32007721845,0xd974c75f228390090080801675b258c043032a46,0xa2ef2f9332c9a7e9d260b7130a2f0eacc1e2af7ef0729730caa0e5400449e860c7fefa20f85ae48051d2346a876171ad
,88,123881,228734691,3,0,32230671872,32001937181,0x2677761b0edf2019029f580431a5f0d76dab5058,0xaa0b5e9b12eafaee8e23b25ccf4e519e08f8f755a4ddb70719383352528bf81d6385a75b020be4a0d9402c44f8dd10b0
83,89,123249,228669474,8,0,32235520708,32006851234,0x9c10ddbfceb7093974c82917e911f507b9759dc4,0x81092b683e53d426723a3474610a188232f057582d54e3bede823459f7f4762d9743f3163b32bf81731b55166255f56d
84,90,123328,228582819,6,0,32234858013,32006275194,0x42daf6c38167707140ddd2546a2bbab127dc2a3a,0x8ba0992b0031f04faab2f076565fa34b1d996a9d6caa39fdd51dd004fe362940fee58e56ea70467f264f8eff92013baa
85,91,123747,228531469,7,0,32238629278,32010097809,0x70bc881d6bfcb321f6f393106d1c37ed0ad35333,0xae6e878bf6851eb2215e6b5edbf023ff50e203d7fb47b66f322cfe887e189a5dddb1d56a6502a3191be81928d7ce4249
,92,123345,228486091,5,0,32234869855,32006383764,0x95a286070f6d80761e58a84297c532621c18a725,0xad2071666de369c52439f0c08c945a407e24d121a00a36a324311a2e57e20b11c591ef269822fac87cd9646e3e6a4b6f
86,93,123261,228481410,9,0,32232357731,32003876321,0x82949649612f0e6233d4bb350536e65d9c1f0f2a,0xaf9957b678747d6b051ab42c0f7b4dbb3bf5adb8c22da1c5da159b3ffd926545380fe2b644059325d5bb88127b6189cc
87,94,123604,228424988,7,0,32233389260,32004964272,0x635d5b96e3f71601f2abe961c249c04fe20a0de9,0xa7a5c65110f3f2dbd5bbe3c1bed2f613c807a896ca287dc3e6df9ed4f2fc863a3fea3fa3bfff24de7aa899fe6025a16c
,95,123915,228399309,3,0,32229883427,32001484118,0x2d06ad28c0306a316e25bd13d9c9ec2d793d8eda,0xb840e5514d983e6ca5ac2d024c9ee394b28638aa1798ffee408d1c7c6b183896431d49824d7302387782b36fa83bc44f
88,96,123967,228304331,6,0,32229674392,32001370061,0x403d8b5465b192077b05836209fc298ec0eeeefb,0x96057e4a9bcb7b396f8abf0b3acc59b78a7c3b524b1255951ab9b8e2a726bec849f743f05f720a55a741cfe89416fc2c
89,97,123905,228299129,6,0,32230095300,32001796171,0x4cfde44716fbd4a357f3b3ac4be756aae52920a2,0x96f5da81c9cc4f2fe9f4574453b4659fff82d343779f731009f89d674edbae01e4db0cfc0266d63065a0f4e566b9654a
90,98,123067,228229398,5,0,32236002416,32007773018,0x3355091b26ced0080b412156aa6b40221215ac6d,0x96905dbc04d0fdc73c3c5b3445d80ecad7b27b7357204809f11be55dea2ec5eff9ab711a909571f6fa47a4ada7df46d5
91,99,123740,228175529,4,0,32232328726,32004153197,0x641b7545b152730b1e42050e1d4eefbcd80a416c,0xad48790ee949dca10bbdced3d70e9871178f33dcdb3a210899f36b8068419dcbb7dec60c7631a05f884ec7af8dffce33
,100,123877,228165338,5,0,32230058865,32001893527,0x2677761b0edf2019029f580431a5f0d76dab5058,0x884ea9c1bbd21fc86028a308cb9ce9f5a11ff4c26ddc283d6e7f31af90ad7593bda32860aa4f616d4ac97b2b3a9ec9f2
92,101,123476,228161494,5,0,32233784879,32005623385,0xd80d8eefd181f2bc79288c4eafd405257f2d83b9,0x8abcbf044a74cd54a3b909ee74b036b303f7ac26546cc4b23f3b4561e4d8cb821372f95e85c084a0e8db6e493b0e8fb7
93,102,105621,228094750,5,0,64436499978,64208405228,0x1ef0ae72a8a1be143055416a1f41112e0d60ebbc,0x96a3462fc1ebcd32a6ee2d1644a3a18f155f33576723e5ffbe6ba6ae65c681e806dfbdc842ffe0cbd2de6a4fef681793
94,103,123055,227955710,2,0,32235640900,32007685190,0x5b5b4d4f3eff0f72518de4d34864370d605d084e,0xa183028e33e033faf4d6e7eec3c6797711a68b39d45182c662d9c85e4b7b70bd09ffdf450314226d8c444fad0e1831da
95,104,123720,227834651,4,0,32232092662,32004258011,0xc407d40ae029ad0b3471b52aaf48ee735810328e,0x82bc47446b98e1e1a6cde460e5b1188176ab81d99f63d37f8cb5c3309ad683ad1f71650ca2af9b06361bc741847f2cb5
,105,121597,227591011,5,0,32253629183,32026038172,0x1bd461fbc9559a689803cd8374a054c3a041c7d0,0xb09882c28799dc5ccdd0f61c9264f1f35432a1ee8e3716ab99f2aae6f74989b24665c1eb4fc95f15a86f31172e4119c9
96,106,124044,227542046,5,164,32227542046,32000000000,0x573b2c5d03a5d6436cb058f9b4abcf7bc3fee55f,0x96d77e9030d3252d277530ed2fab6236735c3b4f152bef823feaa4ff1f29d561288dac91a3183a176198f0caa714d77e
97,107,124014,227420478,5,45,32227420478,32000000000,0xa840c9b73f809c9b603a3bc58d927e6577d5e06b,0xb0721b4ffdeecb34597e2ed882f2cd1886486f0e35eb68e5b34632437dc4b60bb316619ca7042d677e8f8b6d2c415273
98,108,123253,227409353,5,0,32230356611,32002947258,0xd9d9c4924dad181b5ed93e0e9850c21435e9e0a3,0x846831df398b351d63e7286aba6bba50dfd623b6aced0f78ead5bbd39c6d2d9ed88b299ac42861f855a61b62ffc571ea
99,109,123588,227317237,5,0,32232315958,32004998721,0xdcd9b91e3446baaf3279561236ac903439e37a02,0xb5114562bdc90d18f0bcee2facdb44baca893eaa88cd67caa822dcf92de4843e74b249ca3cf730ba9cb5519951f4a10f
,110,123876,227120167,5,0,32229069593,32001949426,0x2677761b0edf2019029f580431a5f0d76dab5058,0x90388b48ae4e3bf1413eda8fdde64e0150e7d896afc7dd7b6d6217ca014cf15a7dee3a9d408710c8c2574a8d6e6c6163
100,111,123689,227052976,4,0,32228962593,32001909617,0x968e69b3344700e37f0bb74911a19e086556ebff,0xb15e448002bd0503d6c8199df0f443236ea86e7dede226052aba82330f44ee49def2f45580fb2e6d029a28541b7cd151
101,112,123978,227008865,7,36,32227008865,32000000000,0x63acafa54e85d8bac25d4b11ef2777f30ddb2270,0xb5c775344b308443522f51e245d90dd961a1761e1b2eef72c4747017415f4fc7567ab70c44c03cc1cea4ac2c82e72d47
102,113,123968,226998279,3,0,32228335553,32001337274,0x9b27f8bc1eaa7d8916e85cd5f73431ae32df33e4,0xadb7b8953049968e17723809a8f63e5197811a3035bc4ff1492115c87818ce128949b3f5e44e681d284b10b42a4e9546
103,114,123349,226997615,7,0,32233381576,32006383961,0x5f19dc21545284060be7aac6f332caa2a54722d7,0xb5109d1b55b66430f4656cd09c778e7ada2a80448202b854d231a3b28ee66b987c4889b870533173808f735874bd2a7c
,115,123371,226966772,6,0,32233249080,32006282308,0x950e7d48cd02b068cbb5719c7de9c252d4b1c6c9,0xa1c8b8a081b08dfefa8c502a45d611d705b15a873f87120b435fa63b9f5245701e9a17007cc9d0ad192caab5f65e4c12
104,116,123625,226863740,6,0,32231736224,32004872484,0x4a9216afa5f8f63b7efc83499227bef7eb7e0ee2,0xa65a2c1d903519617b6e266dcb703630bd462c4160556f182dab9f0a9753f2659b4fd2b8e9e51b7eaa6035f1d2fc802d
105,117,123891,226814117,2,0,32228648194,32001834077,0x3f6e64cabfc18106c3ca38bbd026180da1ef4969,0xb38c5dad3d7d8d1fdf62aee88f2e1cec8fff61747f0fde5c183dc2797bd4b69ebbf18f16f4a5ed81d9e70a7090972d47
106,118,118511,226646448,4,0,64416509139,64189862691,0x6d7abf9052a3e77ec751b4191f4ed1d626a48711,0x9492daf573ae9220e88201327e9a28dd0f28e04e8906b67fbb28948d89ec64f2f0f63d7ae903ce1c4737a80a4e278e44
107,119,123516,226554169,3,0,32232002856,32005448687,0xfa95a508c3785fa6ff3440e24c8a6257c56cc7bb,0xa9c539360a4722905b4d0377327b4105ac2471a2dc323a0f68a738e910b9223edfc090793b7009267b5e60c54f88a0ad
108,120,123828,226465531,9,0,32228715130,32002249599,0xf95c909483b0de63a27f17aa1fbbb31a750ef1d8,0xb76afae2d8c6471037c16d475544c1e03abcc88330ea8fcc78d8f8bd2dffb482ed85bcc481adc6b24247a47009819833
109,121,123773,226389430,6,0,32230323919,32003934489,0xbb82258802c536069cd444821f0a0e666695faa8,0xb09113f55122c18cc9f5e19079b6b3d72d1db881aea5b49027e68613f0daf2f6b9655a2e2d90a3b4e731db8ac9619b84
,122,123048,226343881,3,0,32230346341,32004002460,0x0c02d5c64f40fcfe10bf65ee900598b6bf9f8ded,0x970776bea1607010d6d0859f414afab32becf1fce8957ce26f1b2b6ab8e3bbbda59f54133e22f40396e68a15071bcb9b
,123,123769,226333309,6,0,32230345296,32004011987,0xbcc4fa11c813eb6654aad7782c07086c6d40ba18,0x873a8c768a7135772ee19146df2256be643bed3843cf83c34a62b791003502ee5733463389ef3869a742fa729eb66d3c
110,124,123343,226324748,3,0,32232599500,32006274752,0x3962b5e5f6a46eb1404bc78631ac8ad127c4c348,0xa2953a630330f67562ac86fbb7e26bc8fab695257876d61ef8bcabfae2eb1385e66d4546dece20bb492f2f32675b4016
111,125,123666,226297312,6,0,32230897148,32004599836,0x712032ee5b11effc0de4e2a71ec7fd04042d475d,0xa31bf342acf8c0af16a01b4898e4379fc3501668be54f884ec708173c9fe651aed57389ad188046cbd386a74a071fb5d
,126,121591,226169226,8,0,32255365098,32029195872,0x68498b5bca2049133141e4e9583114b8f0b0189b,0x98e68eb34f71bf264294e8e4f5f650782d025ce0fc6d2100edb60dc56ebac4620a697e3cdad800e24a85e4896bead67a
112,127,123373,226144392,5,0,32232325661,32006181269,0x0ca0a8359862a7dd2ae5b3d7f766b2cee2053525,0x857aaa4a950f23ad75ee7f3347ab72344d27b6242ebf5116b7dae5931a72ba5c02c2f80ccf5638e548d8e0d4f49c0e04
113,128,123601,226114142,6,0,32222838086,31996723944,0x77a8e21f1c922205d08013203b1990c071c5c7a1,0xa9facd8102a1ce0acdb340f44569522a8df94d590b937951f9d1693dbd7672eb25b716db64b71df983049a29f7a330a4
,129,123087,226051750,3,0,32233744998,32007693248,0x54d00e358085df08e664a009b37c6a13a36b26c2,0xa844e40d68b8dcd5c6c67fe15aab3ed07ac06e390e0c1a26d73687e3c376409a573763c34079d90a666d022a9c1212af
114,130,123765,226035025,8,0,32230060847,32004025822,0xf20b596b8276eefea9fcd81556de0508ba7a0e10,0x95fd6308c7600ed14e351dea9944ea8c3762957da54c5443d7e751d39b31c34626d58e463cdbcee0051a9ce7c6c7ca05
115,131,123226,226015576,5,0,32232850679,32006835103,0xae54ffb509b6d014d7f2f0c0e3f6aa47f6ff8dba,0x8c1dc03b78f3bca3a7d255c35af038087b19d38b11348780ff4c35bf2d56e428a4862c090a51cdf719163f53121b7ee5
116,132,123039,225881790,3,0,32233997002,32008115212,0xf90ba291fca4b527e5e8ac1d908f3f5f58dcab60,0x99c36dcf984424df2a64fc00f470836051f2d3a9b16ea482483cd3d8e5d116f6cb9f8269b34de61d5fa593766859da2b
117,133,123709,225875594,5,0,32221916746,31996041152,0xde888f321be9a2ca96e1565e8f3d12f221992b1a,0xafd0353097dbdfed942f340b09463376bfcdf18551d67ea39c0dc98be5338c312504f4d931f6406373799ccaaca14967
118,134,123597,225837359,3,0,32230798832,32004961473,0x63097a64432ac3b86f0a7dc81cb93333c05252d9,0xaf3f2388f2bc9b096e8b204abef6d5d07de5198b57263f0334cc8aee6d3d3e2a62a5de57322545f13b6c37d2ff4dd2e1
119,135,123906,225811965,5,0,32227517127,32001705162,0x14838e7d89c74448b76c3041142f1004f333ba6a,0xa98b4e248a94663f0113cb3435b0d4c3329c502c89d7f8d3a7a58be843771e1621be3d2bc425f15eb035f21901d1b8c0
,136,123460,225799066,4,0,32231567750,32005768684,0x7e78228ecad2b14bec742af5507f102116d23e87,0x912d51ffde4d5d901ddbcdbf4c537ecf0668f6e920aac6ba55d57bc0fe6357de29427d3b4160716754b35cc80d598129
120,137,123392,225793002,5,0,32231714879,32005921877,0x10f46e6ec9868a2be3dd2f3bea0d5a88b06d5805,0x8069c65644c8c3ee947dc63270f241c91393f82f39b59db2cb96cba69ebd3f6240dc4c29c61fde9c749e68810f25c692
121,138,123064,225788887,2,0,32233534078,32007745191,0x86ee3249b87edb65aa1ebd808a7e451d6ddff6bd,0xad345f9880e868d88822fc3cf67e24c21e9328e09f55bd9d376d8fcacbb44b6d9f9b036a115bd4c6a53dfad2c4c1bcbd
,139,123783,225773589,4,0,32229708491,32003934902,0xadffcbbab807cb7e04331fe65c2d7486caed8025,0xb348b7e2441af204a700895f1376db25cf65e08bdac86b185a75120411c37a4b16812f3ee4e4400b8f08d03eedba5be7
,140,123234,225766654,6,0,32232401483,32006634829,0x6839a80a8f8b4f098f36599ab1eb794a31044a10,0x8d8f8c90885f328993dc7eb03ce2818d7f7ecfa3b23100f83558c4adbe0e92fa81c0e044c5711d93a0983f10d92a9678
122,141,123327,225723916,5,0,32232191996,32006468080,0xb28dc5135a76a062382444ef1457954d99241fdf,0x85499177f6bafd0bcb9c6562787dd8938004b1802f133ed3d1c1fa908131b534f2e92e1b62b9633de721df4901d4000c
,142,123608,225713355,4,0,32230649146,32004935791,0x635d5b96e3f71601f2abe961c249c04fe20a0de9,0x97e46465e57d1b48f355d9772303277f6024e3bdf21a489b155195605137bc9cdeef1cb2d32fdbb950e187a711fb59ea
123,143,123651,225695570,5,0,32227798970,32002103400,0x77b2c7e5ae22dec21f03869737ebf3d6dd350ba9,0x8f916f0d2d33ecc6a3fc2fea0fb532b91cbcd2e6c45d8ca0776f2074c2d62c7789cc7c205737a15507382516d7d407de
124,144,123711,225673415,4,0,32230008809,32004335394,0x57665202b06202e575cd77a2428fcf039846f1b6,0x931e44d86cfd67605850e3cec5b1cef9bbefe62cba6b8597fe2492ebf691415d5dc2291d3f959d3a60a2cb1a5a13e901
125,145,123607,225659751,7,0,32230625638,32004965887,0x02800b7e92d88cca61cfc9c2c3f59c3468c86c96,0x875a753578923bf56e43727f09059d5f25a32f9bfabe272ac0c8bda57749fe3a3b30844552df167f36976404f67298d7
126,146,123742,225606699,5,0,32229800029,32004193330,0xc4462fa62486c716269d9a8c9fcde56bce1dab34,0xb6d3480244f742389fbd5bb4b65352a6429d45a71f8c23dfece52f16a454bd431d5a76bae06a26d4bb96c2727f0076a1
,147,121599,225602280,1,0,32251556856,32025954576,0x1bd461fbc9559a689803cd8374a054c3a041c7d0,0x8f9879553dc35a128cce030d2e439defa81a60b4eae726c1fef87fffbd1668e38c902b835fdccf90847426e1f4453d99
127,148,123336,225554778,2,0,32231759571,32006204793,0xbb4aff5d6b60847c7396992a94ecc9a814de46e1,0x89d6132f762d66b6e7106b6372f0df470070e07165363a9ff1d22f38c2ffa72343f274471b83507294702cb0c1ef770c
128,149,123640,225483428,5,0,32230216649,32004733221,0xfa47787a63d326d7919b3773f4c32930ba1440d6,0x80d5890a0e71ca05e4a3efd002283ff2ced86ac6b9e38a15a34eadd965961d01b65da5663ccc2956baaef8aaa620161a
129,150,123514,225439776,3,0,32230986708,32005546932,0xfb53b5da2858b8012f3450b26899b4f804bf9a17,0x897ac513e5bb7c2dc2bdc8b3503b0457bc8212f80b191629fdc5f262ca94eb58e79811e4214a3a6823917d7b75d0c732
,151,121582,225436927,5,0,32222556290,31997119363,0xb28dc5135a76a062382444ef1457954d99241fdf,0x86ce2c506b3580c6f76789f60b0cc3c63127363817e7fbc3d453c24a9b6f589ef2337778e880f3e001520dc204ed3573
,152,123746,225400933,5,0,32229566109,32004165176,0x70bc881d6bfcb321f6f393106d1c37ed0ad35333,0x80f25e9d15bb5875c308eb939a815f1d48cc357b56b4b802c4407a4665c87b56eee54df8881c95acaa3f890ea050a1cd
130,153,123289,225226174,5,0,32218510134,31993283960,0x48dee9e4e921516ab8c4437d676055d009dc60cd,0x90ea4ee54651281f6239e946486967190035fb9d20b31d991e3687ca052f056f87b60b7811c6dfb921304b6d510b125d
131,154,123679,225124343,3,0,32229630050,32004505707,0xd84d55b9a1875dc5929bf540b0738014c4439391,0x92ba636248059bf7e7ae98cfce80dd7252e625d16187f080c71fec23787bd6762e83b5182d585882a1abab89cde774ae
132,155,105619,225117280,7,0,64440819566,64215702286,0xa7cc52b7598c43cf56ef34fbd477a333edcc8238,0x89c1f68dca7ae3647f738537061891fafc1d742a03a8ca26572e5176eb71316602c3a1d1fbd2d4f105e9329853f646ca
133,156,123605,225080672,7,0,32229965651,32004884979,0x1bae7de220f1b11a21bb681dcb320629887611f7,0x9030bef0f20530128dea92519c85a59c2800ca3db0413c934fe3a1536ca394f29f35b9bf9f2e991768cfad29714debe6
134,157,123611,225066572,4,0,32229976962,32004910390,0xdec6620e6ecc221910ad158c703f3bd4e04cf6a6,0x98313dd0fa35df5a2bf869a928dfec291c8b27474786a4737a0b5c6818990eb2a5af19c7a5b681440de9576c742e8018
,158,123830,224980966,3,0,32227221526,32002240560,0x76c85df39405937be6fe8ac1e44b3ef4ac2b631a,0xadfab34040d744af1eac6ed4489a43bc1438f2a53ded3c239469436047cba3e1d109229527c0a6da188ad02edc4d6110
135,159,123865,224964132,3,0,32226986581,32002022449,0xcbeb63cb5a57d4c2914ffb23f76ce9c96f103167,0xb340de47d1493bc9073dff52f3c57a7be3d433bbb4ef17310a9cef993af0d0aadede16663cc76aa9e12ce3ebe076e3a7
136,160,123974,224939759,6,35,32224939759,32000000000,0x07e027883b4f5f126a4d87f037a5ae2ecff73dda,0x8775049ca80912ec1f1a8527fa0a0993a5022b9f22c5f2ec33b854fa38837524aef2c105e11e36d8479bf9c70a7d4d70
137,161,106469,224868505,8,0,64412770824,64187902319,0xd28a4e1cd5d23ee10da8b7b0f9c812694dde50ef,0x91e1149ff3b1054b5bfad5865fd39f2c093da249583964bb205a1d0383d1c833b7ce26b70cbd39425284cf64f9ac98f8
138,162,124071,224760225,6,171,32224760225,32000000000,0xa004fdaad611ac8f02e38dddb446269a6d452895,0xa85028650ac5fcecdd9babb691f11a5df89186e5556373bdb99eddfddbca29ae8888677db628112aa2c92c410dc0fe0c
139,163,123637,224639679,4,0,32229374637,32004734958,0x5560be15a269c748c4f2362f1889a5d7eba217e5,0xb5e3068806011d642a7680f60956bceaa97797f1d48a17c45d14164eef7377ec45e7d1730f33a50f0b70abe242fd4c44
,164,123774,224537021,3,0,32228474685,32003937664,0x2677761b0edf2019029f580431a5f0d76dab5058,0x92be2e0897e148da3cafdd1b4ce519189478d328ae7e7f3692e20ee0321a38faf9f25736d5d61020b3e6c25a88b34056
140,165,123576,224419867,4,0,32229347612,32004927745,0xb9b3dab26083321567cbe18a73b257854f10b187,0x877a24a071ff59b58519a2921041227228d4eac6312343f811e05eab2d442c29d54ed509db41b22708ea2ffd5899436c
141,166,123743,224342458,3,0,32228519200,32004176742,0x7838103c2275e4dae2fa030d3f2613fe0c5418a9,0x8e74c790de1f85d5e6c439c0b8222468e6b1186e44d3cdb193b8f4c0db5eb7f09d574c258a8be104c6366011b61fb780
142,167,123139,224341107,5,0,32231820446,32007479339,0x8f12676ed139f6ac1cca8e311f43208d3e5b3f14,0xa908e24bbb048a7183e02d9eed73c772f64b7dded5e0e108ab789c05ee54b2f97b06237bf38838088fff81e00c54b8cc
143,168,123749,224328275,6,0,32228278146,32003949871,0x59b5de4b3f1022d736e3935be1e4bb659dc07bd5,0xb06911f857ce637b78e337f54c462b41a982b9a5c602dbe19e0e45bdb78b90d43caa489ebbf77f6aef30145b179524db
144,169,123556,224170870,5,0,32221948220,31997777350,0xdee040d342d852d2285155ae76a0464a263e95e8,0x98e957e9db7c2e4be1dc72db255b81361bb8576bbad30f6d99230e015d591d83500ff6c24d960d81f52ee657cb373faf
,170,123757,224152059,4,0,32228241993,32004089934,0x2677761b0edf2019029f580431a5f0d76dab5058,0x83f01af8f06d6ff9987db4c3a9f08d6d03fe50ba462ee2782fcc75db12a1575cd7ed9196c8dcbf949fb842fd36ff64d7
145,171,123964,224131336,3,0,32225455756,32001324420,0x2c16c52580e36c394738f98e1624b13dee50b7d1,0xb0b4200e7c86f81295cf3287bab2574c3de02424f83b440e50aa8cb77fc877f869c8ff10c43a2ef4edf3480c04211ba3
,172,123477,224109030,3,0,32229818213,32005709183,0xd80d8eefd181f2bc79288c4eafd405257f2d83b9,0xb3f4519a3470040f4b395056af258f28da242873986a94ffe847b5bfd948b916f0bcc841c4cc76095ccf6c37818445e0
,173,123859,223978312,2,0,32226058216,32002079904,0x4ade5515303d36758b41540334410301f9e4b4b6,0xad2af9088eb6150f83aa53ab7c993e4e3cf99392f8db4c0628ede04d926ab7fc2f16af3d6994692914058d76fd661908
146,174,123579,223863604,4,0,32228891724,32005028120,0xdb945e85674f72571a455bc6a0190200717415fd,0x83b9175b98682d252fe8aa2cc604becbc4b70642f819c73a2347a3c8d10c0b3afd3764556441966961e1235318dece42
147,175,123979,223863075,3,36,32223863075,32000000000,0xc7684d9e7a2cfda82b6bc42afc19ee502609d00b,0x8cb940d45ce0536c4420c69dda2318693ea2c83b79239a9f13aa8b33ede6d8e4a1c66f7bf68a67bf2a165571808069a2
148,176,121656,223814900,4,0,32250993026,32027178126,0xc1ead339e1a6cc81d90b533832d8c66a6cb50a6f,0xa23a279fa5d4972edd6f0e0bd2432ba19b02d9690685e667934759ead4edf395a31ad2e8de8ee60769e496595c95be01
149,177,123972,223773415,6,34,32223773415,32000000000,0xd75dffc63e5f21a384d465b63cd213e54891d587,0xacbfa9f87e1912de91c7fdbeaeda0a87871f860d034d0655e26dbb0f77400568e313a06a0ec5248599da989510b6a4b1
150,178,124020,223734059,3,46,32223734059,32000000000,0x24a8116b077631b489e6e8eb43a87420f152c79c,0xafa72f61c151daadf6b89d110b671e589e971d9b00c12d6f47771a0ec4158207c1fa01ce6ec44d60b8f44984980d6ee1
151,179,123419,223719726,4,0,32229689493,32005969767,0xc7ceadf13f345e914036cca9849e1f99ed329f0d,0x936fd223bbdc8c367af9854cdff2767cd5abf56a0c0247ac61e30b19becaf5f740a6c063054345ba14ebc7bbdae0da3a
152,180,123745,223703926,3,0,32231010899,32007306973,0xc9322fde3436394ea2bbbddaba03afdfbe175ecf,0x813d4228531e6df934fec68ec093c173c5a2887cebc4ace8a12163245d5f98cd1a7bff82c0c2c271d57888e3a06d3836
153,181,123798,223673168,3,0,32226226059,32002552891,0x5ef44516ca909b70457c483a3e0efa9e3e4e3d54,0x980d939f7d96a13791258dbdc7c080516d5f5917a7188c08f615f917aed7007f08fcce1f2f4aefe9dcacbffbf5442bde
154,182,123755,223617615,3,0,32227690496,32004072881,0xfd15ee7a39d4e2b6aa00cc9f1038179ad8e760bd,0x91de89d1b53087b481db4ac67babe01c969f0104ab6416dbb298aa7c973b2b4db850c7308da9d133290905b952cc5347
155,183,123302,223565912,3,0,32230109893,32006543981,0xb9a87b4ace81415239caf9187995815673e234e6,0xb6f86713e267138ed110da4adb47f6692c328a6ab0e355a057a794f857ee3a4d11a267e65e85e06cbfe6e4087073e068
156,184,123647,223564555,5,0,32229084196,32005519641,0x6c5cc0d2876bdec116875fa1fa7f599bfc266d97,0xa69e9202440525876eb28df684762252b98c0ef4fd1364c74b3003504b5be8ac839678d09bd5807bd1db9021eeead9cf
157,185,123267,223533479,5,0,32227270641,32003737162,0x865697d5c411f52c57f806bf20817ad644b0c6f1,0x893e7e52baa866271a065047367a015639039b4f1ce601286d508673ed7910e8847fa6268c06300605befbddcd9cff77
158,186,123375,223527967,3,0,32229753941,32006225974,0xd2c8199595a7d3726226bbfaa536481cd1ecd6cc,0xb321af821577a8a57742fe3c0cddf1032f7cb6c3548f6b898c88abcadfb90715f371f99ea778a7dfdfcc713c159d60d7
159,187,123520,223504107,4,0,32228887561,32005383454,0x3b7e617afb93194293eb26e058e938f76335cc45,0x988d34d31fac6bb297838a65cb6fd3df1dc8a6e3ab743f9fc2ac29575fed8c153cce2542e5c15998e0d8cf464f7f3232
160,188,123821,223487667,3,0,32225853430,32002365763,0x89b9778050a1bee493fafc0f542c4d279cb56d7d,0x812f2ab7a650385b16b57c0d6d30fd8da735a01abc24b07d3d7ebc9f996e1720982e572edd56f349b1d3b9bde131fca1
161,189,123763,223325442,3,0,32230563362,32007237920,0x731869ae163fc825f16355f581dda727a7237e2e,0x97710bad2e12736bd0ae0a713a99af97f9ec8bc2ed8f9ac6eba3d9e4a8c1e9650ad372e8b10637cab03c93cb9023159c
162,190,123280,223317244,6,0,32230684192,32007366948,0x23e81862267670430c97ac24bbf1a6793d17f677,0x99e799df8af869ce63d84118fed9604e77d043fccb3d0f7f0c3d6be39a47d04afe46bec0bf9ed7b2fa40ef51964b8519
163,191,123856,223315634,4,0,32225318243,32002002609,0x6dc0c5f31598f39b370f1bcbde3ec1a03c2bb420,0x9956b46d9f23bed4e8fbeeb08824aebfe5b0bf363922b2a645335699280a2e4c822b320b4e76f6a1fb94055be786491d
164,192,123237,223298905,3,0,32229989389,32006690484,0xc53572496af3c7997dc2eb23f00e482a1e9fd965,0xa50972fcc7e2bd05aea78287a857874bb8387a06ca60e94fabc012531267dc4524b0bce7d6a24c977d3a684e90313fc9
165,193,123346,223288711,3,0,32229717073,32006428362,0xa3d0baa8035cdea72e0dba2b5626bfa61c79f6a2,0xb6bcac1bc420301b796bb8c6f03e41267a59010f9798be4965eb69d401fcf57be14392dff548d1ede9068c91a7e73818
166,194,123760,223266852,5,0,32227290493,32004023641,0x3251732a8f790ba90af036984ffc3b63ec8c23b0,0xb8e0d288e63ee6e557b26bb62d8f2de48866bf59c4039214cc250ca0a1e694130a972a0367abc743ca059320fcf8f0bd
167,195,123254,223250527,3,0,32229838931,32006588404,0x81f89804ee000ffc03b229deecfe9c443cd4b92c,0xb8ff5c6a5618acf1de0ab35c48ad715c79df1ceb8ad7dc48b754419950120e3152fee7f6414a21233a67953d4d0d55bc
,196,123335,223233303,4,0,32229452272,32006218969,0xbb4aff5d6b60847c7396992a94ecc9a814de46e1,0x940b6d5684e5a94df64f59e0be44324f1a697093c03f3ba541c76acad7202f877354cc67e32cc9ff3749946fddc0896a
,197,123892,223206025,5,0,32225027128,32001821103,0x3f6e64cabfc18106c3ca38bbd026180da1ef4969,0x8477263a1f07b28a076851cc7d28d8bce62a580f9093ee810414884f69411939fd4ab77e05a5198a2ca0667dd45e7021
168,198,123807,223178283,4,0,32225622920,32002444637,0xb1ebe5d3382e3b7344a34a99915c326dda215bc4,0x8c8738ee7d409f51a23091edfbb58cdaa10879131c4e187590f6bafb1728caea46089f10f31d2b3b3487f2c874d972d3
169,199,123904,223149071,5,0,32224917186,32001768115,0xfd9dcaa7200c91d5f07bc23a89b5586acb9e07ae,0xa4da8ed56aa87125238068ed4343ea6bd0778bb504d144a076b9d3b36cf86d3239fbbc7213ade885a37f7a08da0bb032
,200,123399,223145724,4,0,32229294876,32006149152,0x57e7fc26ac6a3d7daa72242243dfcdb3c910c5fb,0x85902ba93b2524b762074c34959dd3b824c654b093d6e21196d8ef8dd6f738bbd40ac6f8bb529439184ce4ee9a2043cc
,201,123824,223116765,5,0,32225446804,32002330039,0x7f3449e2609fbca83423039a955b5213702a8ce6,0xaca4af50fe5fedc515d2307de5baab203164775de8d561ca6f613605cda8baaaed1a688bc5e142f5675693686ba31dca
170,202,123682,223057416,3,0,32224980024,32001922608,0xaf3e59ef39a4b2fc544b53b9ca227f3f153b0b67,0xa2b25ec33aa0667942ad91b0a902c4feb842dcd015bf3fca1e12efb924f8412897d9b195c5e599573323831cf92483bb
171,203,123301,223049650,3,0,32232236787,32009187137,0x0820473f7e10cbd726b377629fd8e529a8ea415b,0xb07ebeade19a7db56f7c6db5e15bd2583475fd962545d6ff7c85d4b2981f41006845a32bf9694b135a515b52bbec093c
172,204,123741,223048269,6,0,32227268359,32004220090,0x7619a3420ee4a7dc23f637b2e403669682d6a9b3,0x826881709a41188f56f095d6383b1144073b918964c026cf3f8ccb57a7fe18e48a01ef8233920e0641f1cd145989bf43
,205,123553,223013854,3,0,32228242729,32005228875,0x6033ef3c85aa8d095bb856527120d6caf5a9c5af,0x959f70def8b08831d1d4be6dcae34e6250954ee4506291dda779a9648ed26a49872a1649d6ab2a26e7fac889dec94549
173,206,123739,223010558,2,0,32227168315,32004157757,0x27b6d3744046e3e60ac65a8737dccb00848a034d,0xa70a1a55e342c3c3139d57a8878823de9a1c0abfe00e0ecd3ea5e3aca7cb0a85fb218a98ecc521d70bacc378374a5d48
,207,123664,223003611,4,0,32227554660,32004551049,0xf568262449a9405b9d7cd223d3a56db9b534be38,0xac1f39899d7b4fae62d46a2d8d85da8b89633e019a872c93a7b5e36402d439023116526e470714c0f0ac92c260c7c03e
174,208,123269,222993290,2,0,32226761702,32003768412,0x653a18182baacfb9360c292bac1978711bf5a3d1,0xb9f71b4f67149c691af2ab8cac7ac9a77e9070ca365bde2c62ce287fab3a32d9608ece8e9fc695b3f10a7bc5ae9275f4
,209,123496,222930653,5,0,32228524952,32005594299,0x58020046d1dfeb7172709be7b24aed84b2c1d788,0xb4c6bbbcd57397ca9a0eacddccfe507ec9967cfcbf491c95ff9e1cd1c80d23a38bb8648a30f402de00051bba848548d4
,210,123559,222917350,5,0,32227993294,32005075944,0x754e40ba838ca7925f78b0fb46a399eaf1c6b982,0x92103f9e2798249387ebfc03ad234a9ac7cf4aef257a5fe08a483c7e35fc49132b6b2a3762130659e4381be55ea790ab
175,211,123259,222888123,5,0,32226769901,32003881778,0xca4bee1aad704d261abab7c43c391673274da08b,0xaec09d43232201bb02d50cf418bd929d8d666604b6e172a080f583a23a0373acd00814736260d1fe14728c3e7bdf7e47
,212,123359,222866654,3,0,32229089851,32006223197,0x6501969cd31b4a44aedf2c35793e6d1f5d8b3d45,0xb9fde00c24a469e4b585623561a43bfa00a8a884b5ad448ae8e52cb0cbfcb05697341f6ce7fe70e78663528bfb48500e
176,213,123338,222860196,3,0,32229115048,32006254852,0xa2fc67f739604b00aee17b4ab95285b92a38ffeb,0xa91557d129bb7f33e39e056a72474c5a6c3225cd009c0f2a96bd2e9f7aae517521343b8d4c2d55d5ec7d17ccf46e46e3
,214,123498,222849150,3,0,32228442999,32005593849,0xd9b003148027bf7e1729448931a92f3e9e8edbf2,0x8f976bbe3bc4deb9464775c6c186ac58c17473c9c86423962dbcfd55166629c0140c892e3a0084f4428c70f47a0bfe60
,215,123558,222843161,3,0,32228102792,32005259631,0x866de382f837e7f3b4a42440ce1a396a88407c46,0xb8ddf50f506cb1c1909becf181873f092e7793e4e99754977ec4f18788c4fae33a14aa1e4ec05b1db3db3e83058d6796
,216,123919,222823813,3,0,32224531696,32001707883,0xf90ba291fca4b527e5e8ac1d908f3f5f58dcab60,0xa18aae8feb836b02d838cc215bb8080ca5e6cf741d2068938d65327cd318e8f43b980a465677435b84fd943f1ed2f0b1
,217,124198,222806958,7,554,32222806958,32000000000,0x3f6e64cabfc18106c3ca38bbd026180da1ef4969,0x8d12dab4c35c82c003ef05202ff3a9c35a20f47b955f52ef64af2633c97b9873999c7846ce1995b76383cf2804d0f7c7
177,218,123562,222795008,4,0,32227971769,32005176761,0xbe7bf77f2cf6d586e5f18af1e55f5049981d5245,0xa4a55ba3a9106fd6a317aa0f886523606f46f1808d1be346b68a20878844b681cf3f21808aed5aae762f8040eec05ddd
,219,123871,222760877,4,0,32224770750,32002009873,0xa3d0baa8035cdea72e0dba2b5626bfa61c79f6a2,0x90a382a240dc507c519e54b845ea893dd0009d75dc68316bdbcb02e2af044e8ef8eb7ec5eff0379c1efe852df10400b6
,220,121684,222730067,4,0,32240160750,32017430683,0xc1ead339e1a6cc81d90b533832d8c66a6cb50a6f,0x88a835044e0128d6a8ddb6d9644d07bde621a677311acc5ff5cc11b73c62982bac6c2b247c09b94c2efc937200867937
178,221,123395,222680123,5,0,32228842045,32006161922,0xabca4c1526fe7953d02fca403941773576de0919,0x90d3d7a072ac6823d95c1f60d0bc04e1a1c4c6b4bb1ac9fc7095681b81f80d5caa3897e24971c654844b036b300e2a75
,222,123586,222674174,4,0,32231350744,32008676570,0x733a683d1fe5e147da514d49aa25eb285683af5d,0x8116def6bfd136a1b9347e46be966373744a85c036a949cb68aa2c3d2306c6ca6b96dd03dd4cded85e9629351a440327
,223,123993,222613034,5,40,32222613034,32000000000,0x63097a64432ac3b86f0a7dc81cb93333c05252d9,0x8ef9ab0be5b9d7d5529e42a21fc874c6a81a941c71fd1fd1c24a9447c838ceaa4dfd812357dfe8fa616cd96bddabb4f7
179,224,123983,222590318,2,37,32222590318,32000000000,0x6232b35fb127130f229d85e0ce0d2f0c7630d159,0x83efd03ecd4bcbffd668bb52c62fa15aa8785dc13448ffec0e4c2bc277a7a899dd1661cb64ee1ffe7601e6019d0f9152
180,225,123699,222587642,4,0,32227054104,32004466462,0xfa624c702be4e502410b2cabfc7a9a574e130f36,0x8ba69f7fd8902d0108c2b84d80b5cba09bf30cddd59e2ffa4ac5edc4a833e4bbbca566ac6e20e1bbe57962a8de5f8558
181,226,123368,222580702,3,0,32228724492,32006143790,0xfbce5e1a72a0bb5f9de94e26a071f6cab322ea08,0x86655a66cbb7fdf1aefd71804f334da96403ffd573a91b436124679fdd207c04b7792ef906c0b876e25ebad88f3289a1
,227,123491,222562768,1,0,32228092230,32005529462,0xfb53b5da2858b8012f3450b26899b4f804bf9a17,0x93fb82fd2959e7cf7beda7def24e750b9fe0028b1b362ce3cf4ae67d7ab6951e3c78b16a5048aa04c785d581f4685bf6
182,228,123901,222555917,6,0,32224376563,32001820646,0xa18da38687a87d8c091fa804aec086908a7e8dc5,0xa7870d91b4aeef441dc0ba4488e3e137a8b97611717f9633533f8a58eddfd25cb1c4d751a6b793f78e8e9c2a3631d8ca
183,229,123454,222521183,7,0,32228203589,32005682406,0x25a8f1d68f352838a8188048e1052476934a2efe,0x817febfaf1dfb79cb8312f86fe3d6156e6c3ff0624135206adbbae1b2e1b03b9eb049a20db26d4094f9d6948d940055b
,230,123764,222471164,2,0,32226436188,32003965024,0x731869ae163fc825f16355f581dda727a7237e2e,0xa532360c9323ad4dcfe08778c3596c06fd7b4e1ae734bad6f84e1af86a08b63e1b645d790963d6af6cfbd6ee5ab3feb9
,231,123530,222423262,3,0,32227910306,32005487044,0xa627aa20485342ca16960fd1f77c547801f7f763,0xb322fe791ff44d0c9e5beb55e1eef2bf030acd5c6e2e593f9ca75020938bbc7587a72605676503c27bdce067c491d01c
,232,123080,222417504,3,0,32230210953,32007793449,0xd974c75f228390090080801675b258c043032a46,0x85331db75662ea9c03cb4fd868c04c95df6b482bc978bc4870e19ec63b2dbd94870c2e8a747194fae9d345f79e01acd5
,233,123490,222384694,5,0,32227953238,32005568544,0x675152957f05e44f52de58186817defb693dcd66,0xa574845b5102f45cb42639bee120c84f6029efa526cc9b6a226e9df65d1b87c9844b24af619b3016eecc872384521388
184,234,123916,222376547,2,0,32224059719,32001683172,0x227b493dbe2ec037c4644079672270e3060aa064,0xa16000fe7b4a0036730ba6c7cf9c8d4222c327f434f3fe0854e8210ff3d573a9ffa2e831393129580632fd75f1d88cec
,235,123216,222368678,4,0,32229294630,32006925952,0x227b493dbe2ec037c4644079672270e3060aa064,0xb1117d026cac72f75f82f949c4f11896f9b7b622438d50eb0c3a5ebe604f02efd9b5eca06e4e9d2c5419a5d7f542a342
185,236,123580,222344021,2,0,32227409024,32005065003,0x04e7ee585af66f41b346f81313488f77b30c2af3,0x9464f81a3275c85c2db5eb421cd1022a285350d79a3d7361d9c369ab6b539f59bb80ef4d0c6926135e49079e3b1b7067
186,237,123041,222328935,4,0,32230414635,32008085700,0x98ada00c2a47509bfc852c188a668a4ef25009e6,0x8878c5e396bf56c3949b7a6f43751910453df01244244747e9b2127f831da895bacaa312a8571ae52341910dc8d6b4de
,238,123660,222253292,3,0,32226867333,32004614041,0x712032ee5b11effc0de4e2a71ec7fd04042d475d,0xaabfadaaa65d5e60c87e22546a0ac606559a78613bc2d579297285849adb85e1ed73f96785c43bbb9b27682f1e004b01
,239,123439,222191052,3,0,32228035174,32005844122,0x20751a65f848c1f308facc537777e6aa2d38bcf7,0x84ff5a29072b756de8ad26b1dc41f8460c70b9a81dcbbf29346bcf051718a44288d2841b90d2fbe4b783395903995c9c
,240,123610,222161529,6,0,32227098202,32004936673,0xdec6620e6ecc221910ad158c703f3bd4e04cf6a6,0x8158c9c908c04c963ebb19e04a42bbe71f541bcd39b4b00c21ffafb667100407ca0536346d5f21dab27ae6b1447c9542
,241,124001,222128394,4,42,32222128394,32000000000,0x3b52091cb78e25e6f399b300cdb7cced4323ba0a,0xa2beabe776d2b01a4e8a53b217a5f6d9c7001c544396a94bb75abb47f72232bcdb2751da3a5d46d0229feae1b722e141
,242,123668,222057776,3,0,32226658907,32004601131,0x08af585321f23e7bd8f617586fc9a6a1212a2e4b,0xb25b6d0de43d61323152d23f465cdf285a7076ef06d650e2bd096e4c1fb258d94835128017f5d18481654618c8d58281
187,243,123062,222035760,5,0,32233032987,32010997227,0x4977294a902e2263a6d7c58a839f5cb1160ea259,0x8a3ab6d81fab3005de86dffd755bda144177f9772f2469598dd8812380c1da3bb54a5e9c6012480a01ec15bffabcd76c
188,244,124041,222014186,1,52,32222014186,32000000000,0x3c683d3547763ef6971b27c743187a39507b7113,0xb8c75e4f284c94bdc4f6449441afbd12943c3cb6afc947e10225254f5c9e51eecb73ebd799104e68e76a437c55fdefdb
189,245,124073,221981137,4,171,32221981137,32000000000,0x98a61b14844fc6c51d62ecd49d2fff793a37f4e9,0xb66b76c81318085ef8386ef8ea71a5ecb2594824d5a3d15f4802e4edef9874347703b08dc08a5cc1fa76353f1b30ec5f
190,246,123434,221970500,5,0,32227920899,32005950399,0x521deb0d352d70868a6c3952b3bd478f11eeffcb,0xb9cbc6fc4a2c1e81ab3bc37ca2cedcb31951d21c2dd668c754a425161765fb34b64cc9467dde099df7cae3a80f5911cc
191,247,123050,221962734,4,0,32229951626,32007988892,0x294560acd8fe87bd5e4a0db5233b26dee871e2da,0x8ec5ee289b9d9c3ca2ca8eeec71a345117e4466b28bc3e826501aeab33ea3e867f327f11913d891427a562919e6853a7
192,248,123987,221946920,3,38,32221946920,32000000000,0x818b317357353dc58a85dda8b0028d1b4b5ba3f2,0xa2ca305af225b2fc0d7ec682dd1b2f887b5df8f61865a3386c671c750408ab1c379ec059e88d44a4b1d9c3e88d9edb5f
193,249,123629,221943817,3,0,32226764803,32004820986,0x33189e4bf66dcbb1318a0956585b229797894ccf,0x8a5059295eb96f7334efa2722178549356ad00f41393cdf5221babd641b9d9d642a9c227facaec16a592df648c638c9b
,250,123810,221909499,4,0,32224319735,32002410236,0x73cf13dbf6526a6147a55de43d054ec2ac32ff52,0x82ee00bd53d3b5ac4532546c25fe617e2eb89703f64c317dfde01e077e7d329035371c75cbbe69e34e2cff50e7c65cbd
194,251,123264,221905097,4,0,32225645343,32003740246,0xbc08a3c115a00aacab33b13355a16c09e5e1c226,0x85d2ed18bd67a2b48945ddf35dc04409cc40c449da6c0f2a55ba68890e96fbc1714a6c11058bc0f13ddc034ced5ecb91
195,252,123479,221850535,5,0,32227539913,32005689378,0xeaeda14da10fcf627145384d6508c9e75e2c7faa,0xac238dfb45967c0aa18b25c783777dacba68495f6d8a7edf21a794eb8d6991ed449899547013f6355e2fd1de5696eb26
196,253,123908,221849598,4,0,32223601118,32001751520,0x7f6655b7ef3f6c2330f7ba5665ffada59422884b,0x85c720ec40abb7e861abddf343589ef97b6a366e9996437f7d3e13248b1f3838bd971b9757bc1fa7089a4a82a63164c9
197,254,123470,221837157,4,0,32227480008,32005642851,0x5fdd9e2368e92d7eeb7f4ef67df592d75252abd5,0xac6d251c5e100dd7089115e4c5fd11d4eeeb6e7142bdf6c34405adea71ea54e22213441697806a26581f74cc38d7a398
198,255,123698,221753983,2,0,32220944553,31999190570,0xce5d80bb4fa220438bef78a8334f4808b500a81c,0xaf6b5683c0164237f7f7efd95624a83df6bba996bf537516643a8bb856455a53091b3f2606525a3659a4c005fc5ccc37
199,256,123616,221744341,5,0,32226581729,32004837388,0xf403172eeac76213f82a5f622d5858e3c8b6de81,0x8d9f1d71cf864a90ee8c4fa89e31fbbc2fbd12594be6e83bc4dca793608311f8fcf0646e4b43881b735bfb8eea7c47b8
200,257,123325,221726820,4,0,32228163417,32006436597,0x8701fd0cc7dde651d8e5a87ae6d2297b73d683b5,0xa2e6ab368a0faa5ac0a29e5fb149f0b78b7375cdb5ba856c19b806c2ce85bf4745fe99ecd1c7722c2df0bde863a9b94c
201,258,123547,221686548,5,0,32226870533,32005183985,0xff6657fb62d096e48df19d3fac645b3f250b73ba,0x920b575c34fdd0ebe30363b80100f5c24740197cd51d90fdd8060ffb1e89823b8beb9c286f3971da8292baf64468d299
,259,123716,221648336,5,0,32217738694,31996090358,0xde888f321be9a2ca96e1565e8f3d12f221992b1a,0x83379f1423b75409a9b631fe7c3e67745d99071df00ebbcea9d83dc55f188519a356a7757cf39aaeca67cf3e43a38e6e
202,260,123045,221559289,3,0,32229613851,32008054562,0x724e42e83c36f5e23102fa8ec6352b6b121b8777,0x8a031deea25acde043eb26af7e323d0b72acaf8c01d76f6edbc38999bfe3068e4d7ec5535cd81f561bb1630edf4fb915
,261,123619,221544591,3,0,32226457706,32004913115,0xf403172eeac76213f82a5f622d5858e3c8b6de81,0x8293d0cbf8e478c97829b8b936f17a7605f03bfe92498007cb89acc9d301d0602946f649ea7d42e74deb7b6a66ade299
,262,123792,221528929,3,0,32223978571,32002449642,0x2677761b0edf2019029f580431a5f0d76dab5058,0xa522dd3b550426b055690011fbecdd68dc5f07ea634c5a827b4fe439772daa3fdf2d0a1966b34fa2adcb3175a541efc9
203,263,124101,221428411,5,229,32221428411,32000000000,0x6e731a5a6effc4013e88d197ccf600a73c068ae6,0xb9167035f0fa1e3dcd2c8558b6081161376ef16da7f350495ebe06f259ca132efd69988daf3aa688f1567cd216ab1505
,264,123429,221402995,3,0,32227355171,32005952176,0xc7ceadf13f345e914036cca9849e1f99ed329f0d,0x93b99a236022da93fa8cb4d3bf121965ef36023332fde7c5e5e359c517813703ca6dcfccbe17b72f3bc4518c39da04ba
204,265,124099,221309773,3,229,32221309773,32000000000,0x832b9c76d81ab1f6bb8f967f394d39fdb5c12a58,0xb6b479e119d8a2678e88282d4e08f0b298a6d4d0952b4507c552c3a633b80478022de0bc9d8e7d19f035829e7a0ac374
205,266,123570,221295047,2,0,32226401285,32005106238,0xaf80e88b0d1fd57440ba51cb48e5e5329428b785,0xb79023985a5f714dd3a6e29fbca27d5ae38ba7fa0e8366055ae8b41247a63ba24972d2d18bef0bac8c3f21b62a191968
206,267,123270,221249576,3,0,32225077296,32003827720,0xe4c629b310ee2e8dc016f8cd551cc46cb1906c22,0x9419755b2c9705db548f66bcb1866baddfbd8dd824abbb37e86d5097bce5614d8ade10ff71e2ec5ecee6b3a5b9b82d58
207,268,123059,221223389,3,0,32229138166,32007914777,0x4ce00f3a2086a5c788b49a23999be092b2823de9,0xa840294570ce3628769892ca54a21e878e77d66faa4e9852180074b60ddc8549306e4cb9ee7a023a035120b9067ea430
208,269,123615,221179106,1,0,32226103643,32004924537,0xc66d8caa717e86954f2081db0c325d8de432f2d3,0xa2f7b591132e67cee50b602929906922a4948547fcaaefeae8b323d48b7b8ca9d3bf4cfc94bd1ffbe60cd8855bdefd94
209,270,123398,221160385,4,0,32220603396,31999443011,0xc9de6550600624faccf1c60e3bc75b88162db4e5,0x82784fd1d2b05f1b509828729cbb3c1093c53bacf4a685ae79cbc5bb18416e17ef3f992349cd405dad64117875c6274d
210,271,123980,221090752,3,36,32221090752,32000000000,0xf3cb8e0cc1ace6b064bdab66fc74835138645348,0xa424b036c5ba732e6e7476e4a712b63ec7a5ac6df88024c8f636610003a580d6d61ef5298c8b0bc7400ef7586d1563c4
211,272,123794,221076341,3,0,32223595957,32002519616,0x0477de2680e46af4278950f303291b0ab4a1e9e8,0x89ba37035f811f54ef1181fef49d2834740b7382e6b84ed089491f4bb7f89ddde19df7c0a398af423007f847aadd9eac
,273,123870,221056343,3,0,32223030777,32001974434,0x2677761b0edf2019029f580431a5f0d76dab5058,0xac290273d6a91ec9512d5c07a995c56a7eda4cbbaa3bcdd6fb3e5b10a196b443d5e35f6b24c504e5c6f555fafc7f571b
212,274,123545,221017339,3,0,32226332115,32005314776,0x54d40daf4bde9f6333c7f88bf2ddb7cc34ecd265,0x83e1fd413adb37c1a1cba3a266a003ab3d8ac254a77255d25fbdffcb89d6f01b2f79c7692b49bfd92486d41cfabd2c3b
213,275,123897,220911420,5,0,32219264579,31998353159,0xd926a891a3db92ba6f097074ce1ad4b3cde2a3a5,0xac454e290b28a2d03c38050ea61679ef711c7a06bfd2c00f9bee00e36345995a0c896d14f4372ce3d5b10d95b338e4d6
,276,123771,220849372,4,0,32224783443,32003934071,0x294560acd8fe87bd5e4a0db5233b26dee871e2da,0xb9c04897d6a4dc58c3c2dbfe7c0ce07ac1c4e77db80655cc5606de5d8354f09c622e8ed5abf21316db2913801a52b2d2
214,277,123179,220849341,3,0,32227902248,32007052907,0x0fc7f2b309328529b2510ecfe2e903e75b2a6d51,0x8b47bae187682990b2e4229515025a03c0663ed559e3e27c7e2d304e14e05a958aeb356a8017f157f8e7a1aff6c7babe
215,278,123982,220796338,4,37,32220796338,32000000000,0xca05cc8e957a5c08a4cf0e432a5c82cc8b592c6d,0x87229eea8834d0896d0d4c353ecae840e1b584eb925b94f94b27a76e8bc37856c81b961db81aea78ac241c285ea4f134
216,279,106468,220762003,5,0,64399944160,64179182157,0x0cf13089a0cf0295a415da97b16051dc98a2cb52,0x91b372137e4e9d6787fab378e2ada03ed4e38edfe0f27fac4704fa23cdb11182cde442a7aa07e983da5baf60d2bc97e6
217,280,123311,220739400,3,0,32227118495,32006379095,0x2e820d9dc8ed86dd488c81419f389a7aff7b06f2,0x862fda3d6b648ef48520b2637cad73df38cca034e221626ad4e3b877b999cc99ad70f3725f38164c2dad58513dc35d7b
,281,123882,220731416,3,0,32222647291,32001915875,0x2677761b0edf2019029f580431a5f0d76dab5058,0xa38d4088d96edac203cfc5be3f872b05c10e7200fc014493de06b7522fdd1fc0a1a51fa3747859f89fba9bc46cdd30a7
,282,123365,220714273,2,0,32226806899,32006092626,0x857646e21dd61f3f92cd95a34841ee3d81bb7098,0x96bc58e02c90e2e42250677e5b459d39f3c9aaa149745a3b2e74eeaa57e56b5ded409f7ff897521b4801b8e98777147c
,283,123244,220707167,3,0,32227353351,32006646184,0x3355091b26ced0080b412156aa6b40221215ac6d,0xac4e2ceebe1fd496ce800202f86d5d61d21dbcd62609bcec38ac8f8d427c05d0f90da774fc817685cc4eb2d0a13f0293
,284,123058,220661855,3,0,32228530414,32007868559,0x4ce00f3a2086a5c788b49a23999be092b2823de9,0x90e4bd7d3dd79dc45997e7a85e9b7dac37396bb599a6f2b6af64c70596157ea4c0ed7bc477ce66531a38a22b605a510f
218,285,123263,220612628,4,0,32224326086,32003713458,0x93daf345a574ceaffbb32f2815b185379fa23270,0xa005ed02ebcb09321a5fd5c5069e0679d0b4c40bdebc9382bda1178aaae02fd8a64ba909bbc290a9305aa9341ce0f45f
,286,123534,220603547,3,0,32225960918,32005357371,0xae54ffb509b6d014d7f2f0c0e3f6aa47f6ff8dba,0xa51a864684410d81d9f78c3b7d0159d54e87ca14b9b868c96f9483d5477f9f731bed391f039efe2e1203f64fdcdaf5ec
219,287,123318,220601844,3,0,32226752924,32006151080,0x73a1838dc1dea58f46c2d0b20fb1d8415a9780c3,0x9044a0cfe70b9272bf8d9038128b6dabb5ac2ef3364e3a3c86160858fdcf57fe05e3f862275ab8314f128dac4a082ffb
220,288,123381,220595296,5,0,32214583350,31993988054,0xbfea9e5b75e40ea9eb5709b99725c9bb9cd7be8b,0x96197989df247c10847c949af57ffd63608292a2ced9e80c59286935934293cb6472d476c017d95dfcaac35225e058d3
221,289,123922,220525818,2,0,32222212493,32001686675,0xe1eadee0972f1379a32c3635b27bd44ed15ab9a6,0x8c753ab4cce5717d8e9507ce45b6b2ffc17f1f88a69a12c58e1cefb0a932ea79329f7619d250db602035bc3430b9e578
,290,123065,220457645,3,0,32228343344,32007885699,0xdab42e4ecb6744fbb854248746c1ca81c4df289e,0xad5a2e3f989de9137107fd3eca591b5cc1384342264956bea9c68558fcc50e11971cf35a6bea70216edd3692d5868950
222,291,123981,220432885,3,37,32220432885,32000000000,0xdf306adc310f0b496861f9e675e1d9152dd8c233,0xb479d8f9d1674add24c44c4540331a8b224966c73d93a7125339352f1690e38792438f927d6141225f3d15cac4d2294d
223,292,123648,220401651,5,0,32222601635,32002199984,0xc81c32eabd07b1cdc349f9a7e56145a31ad513cb,0xb540841f0e223d80b556f2af3f390aad35c957c54bf79534daecbc61f6d121a3f41d2412cc5807ba457bd647e030ea01
224,293,123333,220391956,2,0,32226663360,32006271404,0x9a1cff839360f693d463993bb4593cbd241169ba,0xa4b29184cd58e241331fbd55f78359e649f1a5f3968fa313eb9d763f90e6fae6b00124e5643ef6fdcdaccc0d1eb26ea6
225,294,123766,220383723,2,0,32227442091,32007058368,0x2aad121c29e8f7a75fa1dccd9d43e4ffb00bccf1,0xa53d5f577234bf6e13df4e8ca965961a71d2c2dbad4071f59cfb4b26479c8ef07fb7eb2f30cbde51860e85adf19afde9
226,295,123357,220364462,3,0,32226619276,32006254814,0x94d1162e18fea14802debec960f4d573af2d233c,0x97cac9c4b259b12888e5b8f569d9c9e6f65cd133bcbf82157fd4ade8d0a4491a7ce2fb57d6d0440d77f2c76777eb4211
,296,123946,220333625,1,0,32221841773,32001508148,0x2677761b0edf2019029f580431a5f0d76dab5058,0xb389dc5ff3b51e6788aa53039497c9f0d718a1a906d4a5266a05d50931ec3dddcca85b71621d5e7f22374e4a45c4501c
,297,123502,220296204,3,0,32225804126,32005507922,0x79fd4f7ca658d4f00781401d6ec3ca8c4c2022cb,0xb1bd44161b6a6d24f05905ecf18b21b4d12ca57c38d5f701338522af4acdf9260309815d51800f0431a95893358da085
227,298,123275,220282212,4,0,32223925231,32003643019,0x37ec00125f352e2b93afa3b8275c335e162fe2b8,0x8a17a6c4923d20f3d502b7ff1a2ceb60678c94aa0a79e294f8b887040b03fe1d6d49e8b3ddf125571d75255a0c6eb0e1
,299,123797,220249630,3,0,32222693494,32002443864,0x5ef44516ca909b70457c483a3e0efa9e3e4e3d54,0xaa4b5918d514e116bd6a98eaf16f069d410235a23f64b379c51822b56a0e00acff926f9addde9c56c579c73897d679f6
228,300,123817,220234261,1,0,32222614464,32002380203,0x8f756a83846c54ad75d445dbfe72fd76d27816db,0x9495c79116c7b93509be645d10e7a18ddc0d8584a6e6eb9eaf2f0b7465928427752f505e08ab9d82435fed8c04cd8048
,301,123933,220231114,3,0,32221809139,32001578025,0x7d155c66a91f8ee57845ed33641bedbe59ba391d,0xb2ac3b9b2a7f229f898307d9ec015b086125241e61617d51a73dca3bf654a89223fcdde506aa77307eb215726fc0c484
229,302,123995,220197865,3,40,32220197865,32000000000,0x5fb7e9f38011fa3b80c0b3a9fce835c2f749c025,0xb3142da2cb79c0c50c65234ffc243a08f09b79122fd215324671fe3fe58537b2dbf7c97b4c93cc68aae9b0d6b085f547
,303,123539,220158442,2,0,32225534618,32005376176,0xfbce5e1a72a0bb5f9de94e26a071f6cab322ea08,0xa11fc3e23c52d5798f6779b35e56c837574c4d06a98dc7f0fda568d13e90b373218c1e5363b792d05c64afc6f3001b63
,304,123903,220148758,2,0,32225063593,32004914835,0xfd9dcaa7200c91d5f07bc23a89b5586acb9e07ae,0x91874db17dffcf0aea359ae3ca20e40acb8f91b7edb2751ec4e6039bb58a4377f9966de4957823f4768178d8ad1b1368
230,305,124082,220118554,10,173,32220118554,32000000000,0x75c8c9e5c64e9830814446d3b20b71ce3d19a21e,0x99ccc9983a126b8f52ef1080b61135f716c2e35432be4bd9c1b7e11efaffb3ca02f2c19e8dea76d23c6dab3e4374f3f2
,306,123323,220106412,2,0,32226561921,32006455509,0xf2667438a7bcec847ac58c4ca6fcfc68c152cad0,0x889991f0abe57d061a9020e85525549e442dea3497b4d8242fb92a25fdc4eb20525b211ab69945201d4b90f588fdff55
231,307,123229,220102773,2,0,32226892721,32006789948,0x402c049b925dd377a7bb6eb81ec2ff936fea1313,0x92d2b6ff6d6160ae78acfd54490423f48bf9345dce1d104d9d063a33897137f970d6d95a18f9a85cbd62a4f5d95dd82c
232,308,123814,220100049,2,0,32222477467,32002377418,0x3f77a8c6d02729953358dc60e802c776014b037d,0xa50669b07039871acdac60786712144370fa8ce3fda587e20538fe43f93eec36eee67b2c3c55dd2cfbad02a575295e34
,309,123362,220095403,4,0,32226379145,32006283742,0x3fbccb0def24f07bb5c5d3391c9bf775e0578a4f,0xb129956960603248e74e9ee43906032e9d04551f99e710205a6bdcb4d517f2065035daef6d937600262523d61333004c
,310,123825,220053021,4,0,32222331376,32002278355,0xf95c909483b0de63a27f17aa1fbbb31a750ef1d8,0x8917218b8fca465a8f164d5f8aa301886356c7a7fbb9516a789c77420a20121f7e52f43d8974c6fead0561fe749908a6
,311,123403,220034313,1,0,32226200178,32006165865,0xc1ead339e1a6cc81d90b533832d8c66a6cb50a6f,0x8c997fc269030b4b5d68aa3e2069cadb532691f99694881c6d89604e33eece7a90947370e45a2d4430a0b20be913e848
,312,123453,220034082,1,0,32225767138,32005733056,0x7e78228ecad2b14bec742af5507f102116d23e87,0xb7b75b544842e29fcf5babb495a4bf26eb06ef032f863b1be7aa85c0f6177f45a6d581a167981033e7d493013921b3ad
233,313,123712,219998680,2,0,32224301549,32004302869,0x84e5ec84cf151af780abaee6080dff64d5bf0fce,0xab0ea18dff6442b81335433c80b682f8ea41c4f43192e6333225ad11292d46ea676779dd783fb64ee85cb318b1c3d7dc
,314,123292,219959054,2,0,32226435647,32006476593,0xf8d03584c30d2a9036c58e2bd3079f4bef98456f,0x98a48b0f39d98d8fb956ff6230a5b9030f919e4961cb01b0173702cb8ee17eba52446931f3d35613f4d839c54fd88ac9
,315,123818,219940342,2,0,32222296057,32002355715,0x89b9778050a1bee493fafc0f542c4d279cb56d7d,0x8d79f76eb0fe98865d73d642db3db7f630ef1d0dabe13ed6e74b25b7a7aea81c23d2969c4ad4732e5793d4aca87b81e2
234,316,123540,219918559,3,0,32218587084,31998668525,0x188a724947e569243deae63074324b3fa48c6e44,0xb4d8486c37df7643d114694e28fc82f558ecfe872a47c5bc1b0f7f3ed536820be453eff82c6d9f9bd5eaaa3a4afcfed4
,317,123248,219905007,4,0,32226667401,32006762394,0x9c10ddbfceb7093974c82917e911f507b9759dc4,0x8e4dd0cb0c74644c3f64a806427a9bd84359b11f44deb38b8eb814f538e34bffca7cf92c13f074a6a4acc731bf1072eb
,318,123548,219901751,2,0,32225199822,32005298071,0x54d40daf4bde9f6333c7f88bf2ddb7cc34ecd265,0x8d3864ce2b4b9b58f92377aeaab8fc20f986b630ab4d99f2ab1a6227bda2a12247af6f6dc27a99cbf40455ba1dd83bdc
,319,123761,219897703,2,0,32223965164,32004067461,0xf20b596b8276eefea9fcd81556de0508ba7a0e10,0xb27c266b55109e202b7712b0c46a6bdb22b9d46ef2bb1de0db5f319ed6e65b7618dd3e3fa8a63dd559974a32d9dcc304
235,320,123656,219879249,2,0,32224581871,32004702622,0x63d9b20befedb5c61ad5a158e68c0626ad67826e,0xa0d8facc162aaeea5bac41c16de8b8ab44f03acbad1691f34dd6583435946f06269f441204f7cd2dd84883da83289492
236,321,123430,219876263,4,0,32225730112,32005853849,0x75dd6b2ee9c84fde67b8d1fbfeb1ea7aac6aef51,0xb51cdb8260a57037c42547baca0e07fa52186de90b6a329b4c778104e9d03db528e45b24c6f19128f35faaaaf4f37f8a
237,322,123927,219855663,2,0,32221515461,32001659798,0x9b8f07ebdc8a6887dbd2f0c02a34e9d7ecf5977e,0xae1bf8da53fcc7e4fd20203f4fbe458b39f415c2b2fe912d350e4b638751a0d93bdfeda7e21d4ea5fda3891b5f74541e
238,323,123286,219844744,5,0,32223591751,32003747007,0xe7e8b3031172419257272fda5047027a52dd7bbf,0x85681376a4892fffcdf5b574b89095882a818d381dd6756a559b2c1f8239bc53d0b895714d62d2d01b94ddb57cf6563f
239,324,123595,219833059,3,0,32224825742,32004992683,0x91928bf33a064d2199e52c28b0cef5569ad40691,0xb586a2111971e64e96304534866bc36c5bab073f57e6257ca4cd53aab91df773648e692dbe46c791abed7080ff08f1ae
,325,123499,219817766,2,0,32225430880,32005613114,0xf90ba291fca4b527e5e8ac1d908f3f5f58dcab60,0xabf360c03e9621049e264c3a0b2ded05ad50eced12139ae7d2de0da4f94255dea6176ae937b44c4838579d2477e4f6b4
240,326,123227,219812051,1,0,32226678666,32006866615,0xb9c3f7db93c0569cfbe7656092ac76d0bdbb9e80,0x9802951c9304825faa18643c150c46c177a051121211a8ef94b8a4e14c1c1f63f08a8b2af4d21cf4cd1746e36f2ac917
,327,123775,219796374,1,0,32223794279,32003997905,0x42daf6c38167707140ddd2546a2bbab127dc2a3a,0x93515eb42ea725084848b8c17660af5db5bd2ae23304aba9b75032869c7968a14ac1d63db69e1f0c4afdebe98ced1e03
241,328,123878,219795453,4,0,32221752673,32001957220,0xc9e1e1a5d0096276c53115eadcb3921b216f039f,0x925311346648308415a0b6964b371afef8e8f61dec7dd44fa247cdea596df12b48e1a4b66a5f552f5cbd1038df83e356
242,329,123710,219772094,3,0,32233471298,32013699204,0x4a77d218b0034a1ecaedf7a068d2ac01630e5ebe,0xb81d9648f0001366b059c63a1be2c51f748cd29576fbcc8f7e3c6c3685bf304b43a796aa78f61f0b0b9b6122e3fd2974
243,330,123722,219761633,4,0,32215876594,31996114961,0x79f60ac3ccf6c86d11a7aaac10db193fc00bd812,0xa8b1667fd9deda89f93aa923290cc806d0d9c6e1b3ce56fea77cf129c2da56616618f536ede653ece958c877b6a6b556
244,331,123673,219750343,4,0,32221736957,32001986614,0xbc786693d4119d2bab74a03ba09546fa8e3282ea,0xad4a18de2c3ef52e5427e2ff10b5638a1ed9085c0e79733b2fd5cad6f7657040313b2615b84e4a8097b97380a33d0d41
245,332,123674,219724804,4,0,32221668841,32001944037,0x28cfbab332b343e6b68f80682056ea89fcb9879b,0x92afdb3397e1af1b2fbb50be8557cfe78f63363883f6a2be7dda126e631b481e8a3577d4fdb156ac8c13a9631bbe4d7f
246,333,123752,219696482,2,0,32223823957,32004127475,0x0df7def76fe0b4f7d6e96cc68584c5d01e94d7c1,0xb84312ef768cddd74dd01904fde5ca8ed6bb34a428efc238ad1ab04f85eb530ab993b9d8e18630c5a9ea394db6e1e510
247,334,123251,219689299,5,0,32223506690,32003817391,0x9cb06476d894337301d6830cd22ab8d83e297180,0x9190cf6ce29ccdf32effcf5228897441c9de8a8004a74b0e0190de58749ff36f04dca11879c74bf8c389029af2422a01
248,335,123524,219653607,6,0,32225002498,32005348891,0x2ba66ef8afb79ca39fe89607fd06b6c093010ab9,0xa3ec95df8bc2a13b1eb700a6d604bfd76af705f5b14b1849f0db5fee97e0e30c815a8fedcd6f4aedb81b8acb75089a86
249,336,123305,219649465,2,0,32226255689,32006606224,0xa11c41c194250a2f42c06421fbf8a5f107078214,0xa179b8d043b4b26933cd3d36b6988c9bc6d3fd8f871163a3bf8e2e6e436202f7dda2ffce535891a2d73878442c86c9cd
,337,123522,219591091,3,0,32224892245,32005301154,0x3b7e617afb93194293eb26e058e938f76335cc45,0x951300ed4c8ad50c594d57b870dd1a468ef6eaf3e9696e2c21b3922f63e8e261998fd16641cfd4b18147c63d604642c9
,338,123857,219558754,4,0,32221592123,32002033369,0xabca4c1526fe7953d02fca403941773576de0919,0xac9888ff71b000448e73091769f1b6dc36a07c3055b006c4c6cd4a2650b0f308038f870f3b22e3e3f5a325cd2fa35487
250,339,123290,219551438,2,0,32226031598,32006480160,0x8686486f7505f63f61ddcd973a60938f3a1a61a8,0xb420da45f43c352c1c6fd9edaa6e2a8170c04e8f15e4b5fd1a6ad8bf833b5c28c5ad27830c6eb4de2a4c3173a9dbbd04
251,340,121431,219550806,2,0,64233752829,64014202023,0xdf94c5c09514e01641fa73d03e3b927ce62bd93d,0xa258049f29c54a7f7e573a2d9595dd69d7c30c9f2e4778a5d79f46aefd0c8fc9da2884ba5d68d163f24f4a0d944f73e0
252,341,123546,219546253,4,0,32224793282,32005247029,0xcfdfd2e48f7aca0d3687256beb44fcbc2d87068e,0xb73a1c727fefe856f6a12ff7fdfc116b31eb40c01f5f9759ab01c9d1a71f7ee3f7bd1bf6686d430728d63e930f46c7f1
,342,123222,219530919,4,0,32226305452,32006774533,0x77e88c6b9c638c087944752927ec5a5b5dc564da,0xa5dc3cb36d21df55e00875562ea6287f0038de628bd71486b2311dc49e65fdc5ca1a983a48d0e18685dc8c286238a112
253,343,124095,219512208,4,228,32219512208,32000000000,0x7bd0ec5f106c4bacaa87038a2ed8805497585f7e,0x98eafabce3534083243ecc9a03b035a5b9e1e63cd9213b421a0996d82a451d04144a5660596f3e90bc57a0e23fd71370
254,344,123692,219506707,2,0,32221503294,32001996587,0x82bc34cba96782329692a82bc3ad36029c5fe9a9,0x874647bf6efe37330ddadf398d42efe89480c1f81b68fbedf9cd84d173c2a770de86aa94528dd0e135b859b6bf09cdc1
,345,124060,219503204,2,168,32219503204,32000000000,0xb9a87b4ace81415239caf9187995815673e234e6,0x8143f97ec9ade2015dcf89a4458e38f245544790fae04eee9a363735fadfb25d7c6b7cc63030efd1849416b865e42ed9
255,346,123273,219486574,2,0,32223177176,32003690602,0x91c151a1f30831d9622547580112621ee63d035b,0xb8b3cf569029c4e65a7de62946e9938aa463543e18f5572b984df29c943abc9fd992bf672dcc43f6eca3972f71711ecf
256,347,123544,219480405,2,0,32224680771,32005200366,0xbc6cba69cc8227a3a9335286561eeccf116ca9c3,0xb7cb6d8fa093efde11254b8685be49fc0ab606a75aedcb04bc37113c57cffa9b2f8d923aba20c64a4843b2ee82651406
257,348,123803,219463545,6,0,32221855775,32002392230,0x7afad066efe03e85748c0204fe98ad10285bc026,0xb4e346161d664e54d77c6cf7870318a4028c92574745c13532e75d85fdb7a623718f9d40082c04c3e0735755515aa0f1
258,349,123585,219448949,3,0,32224596093,32005147144,0x33ab831d5f5dcb71bae385bf4ac7d014e6e978d1,0xb1e5f4f37a480e28858f671ea990357c434730f7af7e26a07d42eb846b9df1e70f36d53d98248c92e640a0e97a5625c2
,350,124132,219446470,6,356,32219446470,32000000000,0xd926a891a3db92ba6f097074ce1ad4b3cde2a3a5,0xb08efcef37232ac6dbba33e8d67da04b918bc56cd77564df155f6dd1b137d5634e10be02c4ff098c6a2509be6f1a1f2f
,351,123091,219444380,1,0,32227031565,32007587185,0xd529691c50719856b8b1c5f3d6b4af01afa4c958,0xa00f2584da869128180e6e9da034a18a16e3c6ae9053ddd6bc8c405fb40d937d0c0899740ef8ad76281454bc1a9b4082
,352,123440,219432411,2,0,32218735193,31999302782,0x4006cb341763c02b716b65dee5eeb79728304bbb,0x82445bc125b45813c2e5ef32b85a36361fc80ffda7445b5e18573bc125638c063e0e2c220d2b2e3bac46cbd5a52cbf3d
259,353,123480,219381437,4,0,32224801783,32005420346,0xd901e65f93a31f1d4b41717e8f64c78a5ae62cd6,0x8484059ddc85d0206ba6c8a26dbe6b82147f30d672cae7c52e5691aa86ac816e4576e0c9925e1f553a149c7a3f4c5b4b
260,354,123532,219370677,3,0,32224736183,32005365506,0xe9a04436acc97a03ab2ed6f8a36fd106b4efc0aa,0xae64c7e4a7ff1409f8032ccc41ebfc4051c7033702cea21635c652c89c111eed6238a5c8d60b6ec7a135caa868f66608
261,355,103871,219368357,4,0,64434171210,64214802853,0xf616959cfc26d7d734c28f4437d5b4d25af13b2e,0xa7ce902b5a7fe9a6ce80b9f15bf69116cc6d9fd6d1996214b8aaceebf53828f1c926fd9e9ac246077757ad848b2077b3
,356,123583,219338260,3,0,32224296370,32004958110,0x33ab831d5f5dcb71bae385bf4ac7d014e6e978d1,0xa66a08fb2cf419ffee4c08122341bc54c9ce4f23baa60aed49231ac6cfc7380b9367b2cb0a91b7c6fb7e2b3d9f657536
262,357,123240,219320596,2,0,32223359061,32004038465,0x6fe09034941ac88126f416098b45917a0c9e3906,0xa3ee8c5bb41cc588fd5151421659f6422aa963b91f76c89c7bf44f1c504f4e9b80f23381544f25c14979a721834f23e8
263,358,123684,219313482,3,0,32224474573,32005161091,0x0a10d8f085a01ec83a792ce0d357d6377f8605ea,0x8003ccbe7bac186853b6ba88b52a70f407f1c3f6dd7477f5b4c63ab9fa1fa9302679e009cb506443c4b98429c2d7259c
264,359,123590,219289409,3,0,32224351236,32005061827,0x3771470cc1770d0a0f461944a483b59c27c72094,0xadf0145529d260d33f379df84e6008c0c853739302bf74a3b0020067b5b5ee63a7c66ef63ba102edd8f4696bd801beea
265,360,123272,219248057,3,0,32222954152,32003706095,0x99c5ddc1ff33fe0c361e4f7be99b43032cf21f05,0x8b8b819938b71f86b95b5f8f3a288d61166a83b029915fe27582d24484a5c365110827940ac9635edbd5fa7e53c14554
266,361,123642,219201240,3,0,32223886353,32004685113,0xaf93bb0de8b38a60cd7f92df56b7eaecd27d7093,0x90b5b4426b19f19d135d3673a79543bf797742a47402ede428c967a6ca002f9cec4f3f3df4e9c38daebaf00104e800cd
,362,123233,219189859,2,0,32223136107,32003946248,0x6fe09034941ac88126f416098b45917a0c9e3906,0xa5d80135c87138527611280ac9ad15b65edd4d437b0e1345e4e66dd81dad7d2cf3d784ec3ca8a498890ec40ba338301f
267,363,123840,219187326,3,0,32221422640,32002235314,0xf69c1c534779305edbb5c101d76c8d41c1eb7d9b,0x87a399df808d2d9690843ca3f97f3ef676ad3bab156d37b271f00741350f39230343c1b9a432b8d3cf49b19f8ab66e7d
,364,123984,219177816,3,37,32219177816,32000000000,0x0820473f7e10cbd726b377629fd8e529a8ea415b,0xaa84da22970e2fd1dfc15a014774b8eb1ae0a46f9c8a377b977070e05049351cd476bee2e2844fc7526f0e4d864f7af9
268,365,123628,219167664,2,0,32231813721,32012646057,0xc74d68f016ac2396ab4c7a3262cab2dc9f19733c,0xb478ed031a58aa35bd1cafd23166d5896d160ba5cf86beb262b8b9ae6e8eda8fe7939db9220abac66f413410b5da90ec
269,366,105612,219163902,5,0,64400859748,64181695846,0x2aaeac592750cd4b39e118f0f1dccf3389c4a0e8,0x81b219eb0b5007d9291b109f7aef8d76f70c9247a6afaf844ef2be7086dedf5430b81303d012e030cd7159b74fe5c941
270,367,123443,219042088,2,0,32224855018,32005812930,0x6e158a6f6caee5fff98f8fd3d2d816a216ee739d,0x8bd12f80f7e79e66c17232eb9af943e307cc81692e6e116669d27e2135e54d27b9c0763cf314f1f59426a60b632150c2
271,368,123690,219025535,4,0,32220967868,32001942333,0xd839f190dad231f8b365033eb4a1cf59feacfd2f,0xa2690bb01ac3d0f5220fda89fd1ba4e78d504067ed3c4961dd2511973f6a2170e68cb0016e115e5d1f6262ad66b6e539
272,369,123079,218967873,3,0,32226788675,32007820802,0x15604e24f02fdd83d4e15366997e03fc37773348,0xad08aa00caa3a354bd8d69f9661557f1113cb858074c3588f68f5aca7108c01afbdb9cd1b1d7762ec12fd38976db1088
,370,124013,218962257,3,45,32218962257,32000000000,0xa840c9b73f809c9b603a3bc58d927e6577d5e06b,0xb872ea937df347f5adb4bade32fc2e6f77fc05cd151865b9a3c1b6c52a9639464d0d93975b2f98d9074abba1bc359026
273,371,123639,218922555,4,0,32223724434,32004801879,0xf9d29f701e31d0ed331adeae6570d94c5bdae7ac,0x8da96c5a176d433a5a5902e1ff63a240a31b555285d5b862f81a8d1a2dbfde8bcc7400179d86ac94c100b6ce96f93143
274,372,123883,218896662,3,0,32220829412,32001932750,0x940fa3d510e240565982baba996a62a4f28a5dea,0xaf0a264e42af174061245b42a30f4febb2ea6a719c39de685c2da8655d64885c274f9a2e60c6ac5e353549ee352efa19
,373,123501,218879878,2,0,32224410475,32005530597,0x9af8c16a29af0b8a7caf139b1e5e14c387579742,0x952883b5425f2cf1de6f1e2818df4ab40b90458de8c0cd4decc9e6441446a1f324ed6d09cd9ee8ab4d638ed043b088f7
275,374,123485,218865446,2,0,32224423554,32005558108,0xbfefab110a22ec081a6406eb29c3b2491414a099,0xae8b82be58b47ddad2a9ce31b22fb117b73a0775ed736ca50d33b4daa05a4738ba5fbfaf9604d2c5ac16925608a74f9b
,375,124209,218849753,11,556,32218849753,32000000000,0xe9a04436acc97a03ab2ed6f8a36fd106b4efc0aa,0x91b07be5e35a42c335a6d20aef058ddd0a651d1eddde1b205e377cbdc0ae1bff456a26264b593a56517a38c9279d9964
276,376,123308,218840988,4,0,32228647052,32009806064,0x08f51268b26a7f64d5e72e2c1f391ac2c526d836,0x980aa96971d487843ff9d171e813a9d13c913cfe8c1c266ae1be103e98d92d59578434402ff8dbb3b706078eeea4552d
277,377,123497,218826977,3,0,32224339805,32005512828,0x43bb70fc8356b16ddd7dd1b831f69d16cc066a3a,0x8b02851240f47ad183b77029d5f28baea4ae29f5458e1c1d0c4207ae36e1d24e4a17814c64edec69c9d7e290c65558f0
,378,123594,218826689,1,0,32223797536,32004970847,0x3771470cc1770d0a0f461944a483b59c27c72094,0xb767bd62a1cfdee2a61872ef48b6ccc9e7da01c9cbb4518cc5f57cbefabe2e5e29b807c2674362169abbf14090082c7a
,379,123643,218724064,3,0,32223506480,32004782416,0xd84d55b9a1875dc5929bf540b0738014c4439391,0xaf6d1566e2238ccc7e07cc0b22ca8b3e833b7ec06a3678e090d076541fd5d51399c8a49feaa5a7ec615528d3eb3913e1
278,380,123837,218683336,2,0,32216667672,31997984336,0x0a3d6563a62bb7bb32a75542fcc9ff2cb54f253e,0xaee7ffa1ae725c0e2fd2201532de479f228280afb301cab632bfe57237bde6b30a9762530e373d7b9f487c10b96b5212
279,381,123366,218671647,5,0,32217347999,31998676352,0xb911dda495abb49c4e221ba6dd432ed8918dd242,0x8a5cb4844f5a28637824df37a9246863a87d547bfb7cbe790eddf0ef9f93f52e7090c1d5bb95e9228e168c899c983e2a
280,382,123246,218667488,3,0,32225384417,32006716929,0xf3788f8c826c7f5d33673f78ff36455a73720c40,0x8fbe82e739a15469a1c49b05e433d7f3e1f884c3e7112de7e8f92618ae042f3756df06200316dc61aa8cd49d5920e959
281,383,123242,218666171,3,0,32228389204,32009723033,0xbf2a8f29f7afd7f3040814317150d8958dd06b6a,0x970a42dc007e679177772d7c6b8d9c8be9292124b0a9f363b20c329de59e9bbd25150a057872df827002767af2a12707
,384,107059,218655145,4,0,64455590827,64236935682,0xd901e65f93a31f1d4b41717e8f64c78a5ae62cd6,0xa096ba0c3793eedfd77833bcbbcfdc3786343b312577ac1c20a848859383c9f7fc58d3a2c9f466f2284b3542c63f3426
282,385,124056,218628595,2,167,32218628595,32000000000,0x42da898851c82e8ee8243c12a4722fe8630fabb3,0xa52a37fdca65253d312367fa35120a3ea909d44deb2db4acff94d53740501520db6ac6bb0f4032b1d13b840962ef9ffc
,386,123631,218611532,1,0,32223496550,32004885018,0x33189e4bf66dcbb1318a0956585b229797894ccf,0xb0386b3fb4a0be7ec7db4adee7cdea26c1434e1f316cca8e71bb5f999f23ba910aaad2c62d26eba796c2040284bc8b0c
283,387,123957,218593985,1,0,32219973295,32001379310,0x424762bd0d1104b86be316ac6056b68cd0de0d4f,0x8284165019fe5b791ec402f1b2ede63791d4c1f72a18aa8c063f00f0fde328550772cd3804368ce7a09bc94fa8095d12
,388,123606,218579580,3,0,32223494541,32004914961,0x02800b7e92d88cca61cfc9c2c3f59c3468c86c96,0x936c54d6dc8e0bd75afbeeb0658d17deb1fb2b167e05a0148dbe2a83ed2133abde78640f8eab5702a6fd78debf0d5b4d
,389,123393,218578512,3,0,32224684462,32006105950,0xa05f233eccdcb068bfe7cac35200aac0fae3bff0,0x84a34a0c8ce8762a0d2a9fb9207f44ff8fe9c9a9c3bad85322ac78e0bb020a7c2e081c4319a033a793b8d1c9d7f3100d
284,390,123675,218501291,4,0,32220489837,32001988546,0xa5635f9cce2fc89a6efcd444094f695c4edbbb99,0xacd9c1dd6ac549ca3f97f628d853ae6908e985176aace2041b391e2ff7a1432dc36b4e9dd612d0355d6836e8c6d9f6d7
285,391,123092,218477845,3,0,32226234829,32007756984,0xb8edd43a8d83ddc66d376323ad92891f67d60c93,0xa113097f14a3c8662bbd45fd02d0f3b2e363ae99e169fb64186fb93cd5ab08e72ccd0639cfe26b74d812a2e6ae215bb7
286,392,123801,218464718,4,0,32220910033,32002445315,0x373ac5158686c025964b1e5d37755fc368304e54,0xad78df1e655b79b36cdc2c0b3c1804ae773b1a962f2c342f355a171d8dbad0d1920df8469fd98365f583088363969fbd
,393,123555,218357032,2,0,32223520131,32005163099,0x68ab3ef8d21d20e99282f616c5df54102720a023,0x97d00e42cfb4e95c23218f5ea18360f3670719dba0bdf180acdca0714b7ddf5c1d0ffca8c776ff48a7a5526330139d99
287,394,123959,218354131,2,0,32219764153,32001410022,0x414cf53f1ad16c855c624a562dd98a65edc5ebe3,0xb549927dccfa239bd5e2a6144af3a2858c41db7650047f93071ef2ff48e85936e18db4afb823a21c6abecbd308ef2f18
,395,123907,218352986,1,0,32220061923,32001708937,0x14838e7d89c74448b76c3041142f1004f333ba6a,0xaea443b3cc7fa2f6776e270263e895bba7cdf92c2120086c132e90c2847cce3b135af25b23301d3aedbcce85b565d84c
288,396,123634,218338639,2,0,32223118599,32004779960,0x78f73a75c089790865e56d6811f6f9820d8c7715,0xa38d0d4c1e47876e3c8747d459e5c20219963270a4468de2c403763d66c325f519ab5d8218b17b5b78dabd46bc68d066
,397,123678,218274326,3,0,32222725980,32004451654,0xaf93bb0de8b38a60cd7f92df56b7eaecd27d7093,0xb70ed3bec405b67b30fdbbc475753383dcd2406f5555ed337a111f86176d4967e52c17bb6fb46de3229e9c1b816cd924
,398,123431,218239306,8,0,32219552627,32001313321,0xb4c6b0bbb950be7d08fe577915c9d40df43557be,0x84400f35b6e4414a0d2970e4b47aa203c7c635c80f015357d57421b960ebe314a63dc5539b62e21ecb19ed894f560dda
289,399,123970,218187938,3,34,32218187938,32000000000,0x947bbc558834583b309e428d8b40ad469fdd64b9,0x81d39718b70cd1064b93933a7e6fc767838a6ca0ac5290abed061fc8a7a83651a62fb894c076ca2ba0ef50a5fe4e1647
,400,123869,218180852,1,0,32220218345,32002037493,0x2677761b0edf2019029f580431a5f0d76dab5058,0xac3d47952c40a70942478a2e66fa56eaba7a26a2495057d66057a395e45ffb25448916af213c3a24945ab3e572f082aa
290,401,123352,218043587,2,0,32223854118,32005810531,0x293bf99c8a1018e71a82a9d53c689dea3115cb96,0xa7de9449462e1a0c7415c817fdb9e8d4ec223ec27dfb0c14b1c88395fb01f99898260d1f3391d41544cf8c353f795ddf
,402,123622,217977561,2,0,32222864503,32004886942,0x4a9216afa5f8f63b7efc83499227bef7eb7e0ee2,0xa093020921a018b44b261420a8cb79befb72619111461ac65dc0e2d22d342b3721e58e7c5f4f0003ce8e0c4466d96f53
,403,123638,217953603,4,0,32222689008,32004735405,0x5560be15a269c748c4f2362f1889a5d7eba217e5,0x984fd2312020a721c16980a01e28c4ebaf926213e7f4003db2a3f22f1b19581db428665b2d287ffc05d4a6c38af11c7a
,404,123796,217901345,6,0,32220400054,32002498709,0x7afad066efe03e85748c0204fe98ad10285bc026,0x841a1289b900f607042aed9a87b1a5f40f23bc69ce193b8f4034d1a9b6a2a9db1075f7c45b8042678c0d9edd9a9c9ebf
,405,123758,217897734,2,0,32221975158,32004077424,0x9f2129b00a76bdfd5c08f20f099fb7868a01511b,0xaca3083466e33c1ec55773abfe686d6f4d755b85012ba13bd96a0dc6677b1950e2bb087cacab79f963b5662e47a57547
,406,123350,217810225,4,0,32223698569,32005888344,0x293bf99c8a1018e71a82a9d53c689dea3115cb96,0xa9ab64d910a023312db95d6e7df90c70b674aa2fbe0611994c8f3fbff9c52b69b211c715ef07a3e2a1f4e3e0fecb7486
291,407,123754,217764229,4,0,32221795789,32004031560,0xb9313f94607be76503b4fe36f261840c6aead9d0,0xa03037e23280f8cf96e2b28c2a2b26c16c704c924783f66abf17c64c189765708b2c9d61935be142e72449310de52ad3
292,408,124033,217723715,2,50,32217723715,32000000000,0xce08bb0843b724c10cdf17eebff1f0c00a127197,0xb3c61a6068dc67ba1bca826b2b1172d27e793ba554ca89395f54362ec64549f808836ae82c01d7f2ec617fddeb893405
293,409,107053,217487278,6,0,64380546672,64163059394,0x205cc7641fbedae5224e7961c6698fc10329fd42,0x963087b7f57d6b8d8381f43177eb7f1c5498a8080ac099de4af0bf78e6c9465be2fd8f995054182ac183f3a2ea142d81
,410,123811,217478589,1,0,32219948979,32002470390,0x3f77a8c6d02729953358dc60e802c776014b037d,0xb732166ec422f3538e37680260389904ff8d731629afce5102fa36d57277553251594b9b6fe5d9d6a914a84b5bb70f0d
,411,123804,217435330,2,0,32219889261,32002453931,0xb1ebe5d3382e3b7344a34a99915c326dda215bc4,0x8d602daf8c0d577c52bb0389a3fb97811b2ae03e7f339ba29ab64c9a440cd362eef1a28a43a3c2ca1b3111ba4bf8b13e
294,412,123347,217430571,2,0,32223682844,32006252273,0xf2ef5efa034d952cab7ea7d70bf991a0254e4c85,0x879b14635d8a3583de434e5131ec770b76a465a7e60d84861741826f2d986150a53cc9ee8de660323b554e44e151a7e2
,413,123834,217402299,2,0,32219701157,32002298858,0x2677761b0edf2019029f580431a5f0d76dab5058,0x9108411c36703b504e373b6fa5103de288bf920bb676879c7c7e7e4a84f96d6ec489b5d60e08353ce30210663de11aab
,414,123795,217381718,1,0,32219864293,32002482575,0x2677761b0edf2019029f580431a5f0d76dab5058,0x893dd0677ce266fcd6ce6bb065b7d46602b787110bc50fd8428d0b4b21ebdc40a5c4c88fef5c8bfc4d971b192f946a85
,415,123805,217381295,2,0,32219889806,32002508511,0x9ac6ff47ea5a6a30be211ccbb4b8c488f74de778,0x873e723c1e6cfcaea618a662b36626dc45ea5930ce5b7e54fc386995cf6a421c692ec37ea3d7f53f00eaa5954fd1b96a
,416,124191,217372141,8,552,32217372141,32000000000,0xd974c75f228390090080801675b258c043032a46,0x830b6255d1a4b171ec1309a1a6351b97590db229ed4fce81548af4c968111a4fafdf2c503d3d96ce76c95187cfaf1bd8
295,417,123471,217366075,2,0,32223081674,32005715599,0x481cde8a1a9de191821edd0a60e8ef38a433562c,0xa6d95c46213e641738de5346080a48058ed5556b41a3c912865eee696d134c6c29158b3900cd10bb9730b8852ba35b8b
296,418,123826,217353360,2,0,32219570802,32002217442,0x6faf6211b29da72cbf5e99987b3ce8c70d116e2b,0xade1fa396e4ce59018b5c2e5c82ecbd86f8a97b94898db89a4fbeb146ce5b274c631dabca065dad94871d98e493bb3c2
,419,123360,217331330,1,0,32223602713,32006271383,0x81f89804ee000ffc03b229deecfe9c443cd4b92c,0xb2049f755700515802a73cf7dfeefed9a71189bd636cb9c92cf14e121a63e296c96176d5c177b72d282a7b625dc2b483
297,420,123571,217311494,1,0,32222484567,32005173073,0x065baf0a6a153c70ea3557301d624b68352b6846,0xb80e02df1023aec03d0cdf64b2de6c79f840df90cf67bf8cef9317c0e9f4b0cfab22ba2a4920de28116f1b4f5e8f20f6
,421,123827,217306315,1,0,32219630127,32002323812,0x6faf6211b29da72cbf5e99987b3ce8c70d116e2b,0x905d21f09f66e8b3dad620724749000869d84074316f5cb53e0483545dec0f1c80f80a584bad715ffd33ced5d4443538
,422,123461,217295832,2,0,32223080078,32005784246,0x7e78228ecad2b14bec742af5507f102116d23e87,0x8a90b8b8e27e34fbcbf77482e6f81bf953b11f186f53d62f9da3fe998b8c0a9e2120a15988077a0f256e047b22fcc5a9
,423,123457,217281388,1,0,32223028410,32005747022,0x7e78228ecad2b14bec742af5507f102116d23e87,0xb72a8a235bd6fe208e0cb9ed57d9bb680c26d8a33cd1f39b7528f014cacdf745c195b6b8dab82fad5174f647d1d01b37
298,424,124128,217262476,4,355,32217262476,32000000000,0xd699cb99a870df30d6ab55c9a05f4ef360ab904f,0xa2c22b724d21cd5d2e149c5bec9ea8a1fbe4b420552a867728ccb15a8071456e734f27937312629a68cb4a439f7291e7
,425,123239,217218805,2,0,32224034426,32006815621,0xc53572496af3c7997dc2eb23f00e482a1e9fd965,0xa5372b9e4fb19dd3e4ee75ab54baacb931a184431d0b9aedd7dcc2ebcef853783d79705206146ef6d60c4359a8f89000
299,426,123410,217212085,5,0,32222976117,32005764032,0xcb64923781ee85e71b85ae5953f30abcc22b87cc,0x99c1aecccf90f2dea8a7a45519059acee59db0f00e003e2ef069daaedf69f28d51f8053283d2a1347cc080d63fac5933
,427,123518,217203820,7,0,32222689000,32005485180,0x2ba66ef8afb79ca39fe89607fd06b6c093010ab9,0xabc4b20fc9fa9073d4838a148c5549ca3ee56c6e493ddb7be0894bc8fbdb655d0cc42d577ac0fe54a7a83e7fbeef8eae
,428,123926,217199827,1,0,32218820667,32001620840,0x9b8f07ebdc8a6887dbd2f0c02a34e9d7ecf5977e,0x8d490939d70e5476b2996e89fef2dac146d41a0b92599b10ec6125b4ef68789c25b48c562e9bb06a25ed4614638cc4b0
,429,123040,217191574,2,0,32225225164,32008033590,0x7e78228ecad2b14bec742af5507f102116d23e87,0xa05b1ea0de6ce0fb0e0ee00983e02e711c2cd1e8d366bb8f205c560c18c2b17e7b8d74832189da0e3fbe8e297b809e73
,430,123076,217187839,2,0,32227269151,32010081312,0xd5368ae7e579d6f589b6f59ca12e335a6dfb0001,0x8b12ecfc810b5d0adf131f3e361d3b9e7bb73dcb7a1e18cefab7bf123b3ff3a9f12668f371ab1abbaeea36413dc291c2
300,431,123049,217164473,1,0,32225049797,32007885324,0x81fde731740c938d51dc1e104e1ddc41ff32e0d0,0xa70696ae6d4fc7db69fbb6e0ec517b00c315c39fe10f3200398daa5c1c18507e405cb3d7fcea96d33529dc99be1c3e5d
301,432,123912,217162865,1,0,32218885601,32001722736,0xaf51e73253ff2faa8ba8c90615831014ac3a7717,0xa4cd64fb05229df4d999cd9aec0f5340b3fd3cf2f5d1909868f1f435188c034cbec82eef49e7e3f564bd26c529f7e52d
,433,123527,217141391,1,0,32222488607,32005347216,0xd8f9b6bae3a9140be9ee4aaf099e3b3c6993b2c9,0x89e3346b8de29f79eb6775625d79801aafc041f2a9e8dcc6201971928b24a28345bab5d0dbbedbd6fb7175587949979d
,434,124074,217105431,2,171,32217105431,32000000000,0x98a61b14844fc6c51d62ecd49d2fff793a37f4e9,0x91134d34c92aac5a8e5c00380cda108ed256690c2522a1eaa5fa991d3abe4a0615ae45948bfdeee5a14fdda6167a644c
302,435,123941,217089646,1,0,32218611893,32001522247,0xa83dc8db3637f79fbe6eebfaf8e7017fe46e40d4,0x81a043f0ebeee4ffeebf5aef70902512fa9b1651c3027fd28ba5862ddf877eb04dfeabe33c2dfc153ac02ac498b5e183
303,436,123277,217083034,3,0,32220724084,32003641050,0x9bc242fba4e45dde003967371a62c829557f7c86,0xb1f12c7b26435c694d7d8c81d2faaa0256e138d0882f8547afabf87b78b5b63d57f0716c259729e33fa68ca99a1ac60e
,437,123768,217044030,1,0,32221023834,32003979804,0x2aad121c29e8f7a75fa1dccd9d43e4ffb00bccf1,0xb1494a074d26d54afa68c0546df85b1386c32ab701f9ac3df54389d2d60c5294b704e7f2bd2652677de1173481eed46e
304,438,123196,217020432,1,0,32223855071,32006834639,0xb6d59f7c2e6f884f2ece7951e24107da5dddb4f9,0xb1591a060b7be59d6f306a612d71a9438d288cd16441d03c5d859ccfc43f6a63a01e42e32f15cf6f210dab7465f83685
,439,123511,217009259,1,0,32222482430,32005473171,0x75dd6b2ee9c84fde67b8d1fbfeb1ea7aac6aef51,0xa72526d7869faf4a76e186a3998f0115166428df24f03316135af6981ccc05c978b5a3c601e937072156a4b51684a639
,440,123401,216934478,1,0,32223099574,32006165096,0xc1ead339e1a6cc81d90b533832d8c66a6cb50a6f,0xb829aaee691df69c7656396caf1634d3c056aa51bfe24e2dd008123a44e5e66247e4b99bdd521a8cea8562401c21d2f3
305,441,123676,216887110,2,0,32218877592,32001990482,0x016d73eef3ca97ebca8959372efa4e0d568c725a,0x89cadb9b610a6c53b08b86340c48b9eeef2174deabfaf756a57520079920e93a29d936c9db513332c64033812a387cd2
,442,124002,216868364,2,42,32216868364,32000000000,0x2677761b0edf2019029f580431a5f0d76dab5058,0x96194a7ee7033fc776c4838fe3f6473a4927569c07319a69925ec1c670a7778e2c608cc8a4e7f9198a8ed107b0ea68bb
,443,123458,216855800,1,0,32222606994,32005751194,0x7e78228ecad2b14bec742af5507f102116d23e87,0x98e15e2bbc8509c82b789f169f9948cb39dc12fa1f6084de6bb4f565707a8283fe86a880b2943bd95d57959e9045e2ee
306,444,123591,216851868,2,0,32221984513,32005132645,0x9cce8fb782d67368c202214926310e3e0d093145,0xb712e22fcc44898df0dbc55dea141f239d889c9a1d4d32386e44f1ed3ca3842be37c7309a34a332abe2385872133bfa6
307,445,123245,216850588,3,0,32223518065,32006667477,0xa801dbdebb90257c76215a6017d164771e42ba0b,0x8efc36c9ecda4dbd56d2415f8b6b46429511a636dd1b3c8e9bd4afd03a1de111fc3971b547ca709705255779e9b77b5c
308,446,123525,216811494,2,0,32222207161,32005395667,0x1e05967e01d30044c6d4102a711ba6a039990967,0xb29b9d9f387692edb2629ebde53d182d7fd53eeedccc95cc2fac0acba3380c6e6d159fd42f7818e06b587b09ba82902a
,447,123751,216805213,2,0,32220911773,32004106560,0x0df7def76fe0b4f7d6e96cc68584c5d01e94d7c1,0xa24f7f627d5c61e6798857f2f3b81b8177b8cd19e943164e7416bd00fd3e838ca2ddb4e84c2888c388f4fd9b285ccfca
309,448,124093,216800894,3,227,32216800894,32000000000,0x9d1658d8ca6ad26b15b1daa90bd026481baa3e3b,0x8ed340e1dc35a7e64c687263d1b162c56b854a5628564f924968a2b94b819350c04d39516ede2694d9135f032eec07cc
,449,123750,216790547,5,0,32220804805,32004014258,0x59b5de4b3f1022d736e3935be1e4bb659dc07bd5,0xa42288f8af29ed45f312cb2505b9f5d1dd9228b4459de3492999641b2af2b2242f9dd037e63ea1df2d5494d6d0ae0691
,450,123697,216783943,1,0,32215984646,31999200703,0xce5d80bb4fa220438bef78a8334f4808b500a81c,0x98324e08388c3c9897bbdc913bdebb2e5714e0be8e97eff0e2330e1467b2a58c39162e3eaca2dedc13ea616e485711e4
,451,123770,216759955,2,0,32220659898,32003899943,0x2e820d9dc8ed86dd488c81419f389a7aff7b06f2,0x8cf08d6a755a3ab3eb9e0f197be14d20fe1c27698d36394006ba425e342c680811fb25dee8e410c2d210d92b0773cd07
,452,121600,216751141,1,0,32242582587,32025831446,0x1bd461fbc9559a689803cd8374a054c3a041c7d0,0x904e1bd85b7c762f1ec2b6d882276ffff5e14e71c42b788180fa34f0b0e2689b333802be67f7bc1089801fdf0b793b71
310,453,123402,216659492,2,0,32222646334,32005986842,0xef44fa4472382901d2b83516a8deeb2890eb882b,0x958ec4e33b3f700d1b7b2547fc54c7d8baff7d7c325296780d7a212425e39cc13150d76f1638492ce2d42c9186782ac7
,454,123552,216631122,2,0,32221823196,32005192074,0xbe7bf77f2cf6d586e5f18af1e55f5049981d5245,0xaea877af041143d80347990b5cf865dc3cfdf7bc5afe956b1d630538df1968381a65ac8737aca26d480cbb65effdaed4
311,455,123721,216626785,2,0,32220972709,32004345924,0x42a62f9953cd47da89e9b8ff3249bdfd569e4ab3,0x94e69d66aee0dbf8b6c8ce13e4e143c77bd66e5aa215fff79da02ac3f227b1a1a3fb7aacd1199b3ce9c4175bc0d4b12a
,456,123910,216617779,1,0,32218344485,32001726706,0xa11c41c194250a2f42c06421fbf8a5f107078214,0x844391c70438b33540303570f7de9b33e7a20bdf6080b30b6798ee9af4d23a981a1ce71c76aa378a71ed37478943cff2
312,457,123784,216596488,4,0,32223645724,32007049236,0xf4254a5f6a82474295ba01f7c0e4b0345c8be8cc,0xaabc6c4e5bfb7c09f5e02e574051b6d7c776ca403d6c2a25b75536208226f4135e2ef7dde3b3b4d6f7171955f7dbc7da
,458,124104,216572772,5,230,32216572772,32000000000,0x6e731a5a6effc4013e88d197ccf600a73c068ae6,0xb68aaa2ec8b5292ddfe94c43904385b8ea7678d4a2d79585289f49bab61d8e3d72b9b373ce45dde99f075af55d8d72dc
,459,123061,216559161,4,0,32224345344,32007786183,0xa801dbdebb90257c76215a6017d164771e42ba0b,0xae04286e6b899df85f41dd0219d7b47308d765a95e0f091d14327e2152a0bfdfc54d3dec70c77cf533bf8611605b2b93
,460,106467,216545191,3,0,64480258373,64263713182,0x0cf13089a0cf0295a415da97b16051dc98a2cb52,0xb88dfb084075ca0ef04bb247f251d169510964ea8a69a59ae3d3f310042b9986013dc33924e00672b6e37dd37a30c18b
,461,123424,216527761,9,0,32222163983,32005636222,0xcb64923781ee85e71b85ae5953f30abcc22b87cc,0xaa8c951fc70bfb230a6ab20943d2c54a51d5d78a8ba69b15dd5f5f52d91448441edb56bd8dd0774d3ec8f9cf075292e1
,462,124003,216510394,2,42,32216510394,32000000000,0x2677761b0edf2019029f580431a5f0d76dab5058,0x91c53af22ed03a6284190e9ae009d9fa88cbfaea57214055e4450373bb98415f913362e16b6ba5dfea0b8e9f8b86cbbc
,463,121430,216487658,2,0,64230749190,64014261532,0xdf94c5c09514e01641fa73d03e3b927ce62bd93d,0xad8b963dc6db5b0cddb013edc5d8bd73ce4be13eeaf9cafcbfd380faf1c23f6378386288d0d1cb72e1658e1b0935d22f
313,464,105288,216473923,2,0,64394353539,64177879616,0xc0eb84422ea5691b29f99000a84bb18636e27471,0xac4512ff66041690d290659d10440ad492491c9645dd35201f8ccbac037b32d2545a9fd405b6260534dc09b5ef08e301
,465,123961,216418265,2,0,32215164736,31998746471,0x48dee9e4e921516ab8c4437d676055d009dc60cd,0xa2bc1c75f6d3bd774b9e7f6b0286a8ae69ce69c5cf66e2c5c2d74448869244a0c61d6190024afbc4398a0632773d5628
314,466,123686,216384581,2,0,32218292046,32001907465,0x936468658dbcfb8edcb89a609645fa5c9514a970,0x869e5345ba35cfb92af2424a1d7064c146d872b370447561929d935695873800fbd60b18fc9836892164c7b9061ebe34
,467,123047,216373219,2,0,32224308314,32007935095,0xf90ba291fca4b527e5e8ac1d908f3f5f58dcab60,0x9a00eb4933f50b66084373b8f2f4f2dca7f2b4d4cb1c79c12d77230ea0f2bb4b128084609379c487f80b6f827f2d4b72
315,468,123748,216367840,1,0,32220512729,32004144889,0x5f509e56de09b03c0f1dfcdd6b63669b46887245,0xa6573dee22e68a4b0881b2f194ab3250c3ea58c36d73614a91ff691639e9faa640c7a38f021bd480980b9bac7469a0ad
316,469,123680,216340003,4,0,32218246073,32001906070,0xd456d8d3605999c579a2981f87e511be3912565a,0xb3d1f61f70e755516f1d6dc94390879cc6361b1676067c766e5552752a2a3a504bb086680ca52691749d4bc433c3cc9d
317,470,106465,216332694,2,0,64394839865,64178507171,0x6af4e87b398c0986d81ccf59022bbeaaec2f5367,0x84317fcb8be3f3884cfa5c3eead72770347f705abc84ac0be89e41bc3f323a4975d9074d263d5ef6b493eba6a76fa0f9
318,471,123936,216325093,2,0,32217835577,32001510484,0x1cd7aecdbd04ec70252e5f15c7b9017206c017ce,0xa45cfb452289a19daec6109ad6502d7c8edb024e2b58ea3cfde87a9259298eaf02c982998b85cff601e034de9140cc90
,472,118489,216323119,2,0,64403810156,64187487037,0x6d7abf9052a3e77ec751b4191f4ed1d626a48711,0x92851d168311e57b8751c088e1993d5ca066f1756465d5c51daddfb5ead51e4f515d96697b17c08a9e27b75bbe833961
,473,123719,216321813,1,0,32220539833,32004218020,0xc407d40ae029ad0b3471b52aaf48ee735810328e,0x9825d87af5661a240cd7158c422030125851f36668b3571c109bc045a0f9589f9800c19ee30c93b33598c31c329d55ae
,474,121598,216319790,2,0,32242486901,32026167111,0x1bd461fbc9559a689803cd8374a054c3a041c7d0,0x883939d8349b6483a6b9ec9623d92acb8fcd637f72eaf397673d803e953c1fd04f2462069473a4a9e6878d9a33bee6ed
,475,124092,216307537,3,227,32216307537,32000000000,0x9d1658d8ca6ad26b15b1daa90bd026481baa3e3b,0xa328bcd91811ed6af10b0e5cbbec4a400dfac487b2d31acf024e981ed58d43c5ec80b69abb3a3e99c79d18ca39629717
319,476,123268,216273388,3,0,32220055745,32003782357,0x169467e4b162624d45bcdcbf146cf9f77bec577f,0xb390b04876b4c13dc83d467fea01851dc5270ddc6ae1aac4f66d94ccddb45b5fbcad6aefc38a90c0f6a5699696ef5463
,477,123394,216231505,2,0,32214989758,31998758253,0xe9a04436acc97a03ab2ed6f8a36fd106b4efc0aa,0xb36085e2ecc2f49fb828ed8ba20c6d747b0d8d05a5a374767d196bc69344b94cace2f602137964ace4f2accbda510188
320,478,123478,216220013,1,0,32221864072,32005644059,0xbb413d970d30ad1b6f2074a2413efde55eb78de4,0x8e6e518ed80e501df142cc57e018d60c3b2006a68f3b27769241faa1499da56e387622d752990092fcb796ffbf183a9d
,479,124236,216180270,5,625,32216180270,32000000000,0x724e42e83c36f5e23102fa8ec6352b6b121b8777,0x858e4cdd459cff1d34301022cd4cdcd14cdc182c3b3516ff61b063a815b6ccbf8c60f5819b8aecd4ef07ca66876f5a71
321,480,123231,216159976,3,0,32222746123,32006586147,0x6de8f905b46e36efa2dca25406fc07d87e421663,0x806a9ac2b9935f74e4697a94c01a0c28540a6f0f775c0e48da8b5108121b506e94f3b2460193d41cd557e167274fef1e
,481,123636,216154810,2,0,32220949079,32004794269,0xf9d29f701e31d0ed331adeae6570d94c5bdae7ac,0x900edad326a67e3e9830f2e6e3eab20b4cd2d14e4fa8abc4635f2243483b1a171236430ccceaa3007b97944ce47a8d1d
322,482,123276,216057678,4,0,32219716454,32003658776,0xa850a1d091410d17d0fd8073283890e5b74c2e55,0xb58dc376e07c67fc8557e892ab3c789b0fac4504074983e4dff120b72607f7148f4df9e725255885222886091cf6e752
323,483,105434,216049121,3,0,64486244744,64270195623,0xc640a1159fca4d23f56b746c3ba1532e6f0276b8,0x83de0232c0d4b2f84eac7abc471978027ea6024f9cdb731521edcb37a98d0bb4b00412b0c52c762f6f4d1b60fd883121
324,484,123482,216045039,2,0,32221570808,32005525769,0x39d16f71d6d8c9fdc6fafc0352900c5d74351f1a,0x8bf59327b4c93a281b8bc7e74e853632423fba49ba61c883b1cf6406ce009e1212bc0a0da8f749b2e8f60fb48c6bec0b
325,485,123696,216036552,3,0,32217979453,32001942901,0xce197e59f131bd91e137f956465fcdd069ceaa6b,0xb80ac9f21d505470669795d83c4df9bcd6d5f9ef353fe77f8640aa185041362939084989d0225fac94ca00c68612fb63
326,486,123279,216030028,1,0,32219733104,32003703076,0xff7af699cfd9390196e16176701ac8336f6cb30f,0xac560506f7437555b0dddbe6919f292d4ea2ed933e8079c6ea888b117825a099a52b8143089c5d963268ff0e8bb43d14
,487,123864,215995989,1,0,32218032456,32002036467,0xcbeb63cb5a57d4c2914ffb23f76ce9c96f103167,0xb850a81890a14d2fd7732b149eb50524cfa5f829074a5ba7f762cd51e6025328b55b3d7efffe5bd91243c54f1aded7e4
327,488,106482,215988792,4,0,64389729921,64173741129,0xc9edc1d5e8e2ddfc7f453c65226ad971545b8d49,0x913f81414475e2e5e6860e53d6424b6bbca5c0a5d49e7998cc50b3381b31e7f31a3248e6a6d2ff6b8ec62e3af4ae9ea8
328,489,123650,215961351,4,0,32218096960,32002135609,0x7f6d47eaeb7e5361880a36ad256d5afb66c177a2,0x85a0b0e90f8ec64ea6055d60012a8f1afa43e3d32442873aed6d4e297eb819143c9e9bb357ecaf0415d2497c417e2375
329,490,106473,215949142,4,0,64465073975,64249124833,0x8406207761db4cd6773a5946436537b798b61979,0x8194f56b0e2ec2c91f9896de934e2353749190918b726af3d5ce24e1c5a33ee11fec330f41b83a3248a5dd0565fef90f
,491,123902,215930622,4,0,32217609527,32001678905,0xa18da38687a87d8c091fa804aec086908a7e8dc5,0xb53534ca125979eb10705e4bb586e7576e9e900ed0d1f04bfbd48430cb1fdf6d38ea7e72b730baf0d53082c7aae4be59
,492,123632,215901047,2,0,32220622263,32004721216,0xc74d68f016ac2396ab4c7a3262cab2dc9f19733c,0x81feb0c1c38d75ec519374a6059d3278383b32d40f3052995e23da74939590e5a5c8a54cc9cee3cd00f342c61ea61853
,493,123043,215840993,2,0,32223920037,32008079044,0x98ada00c2a47509bfc852c188a668a4ef25009e6,0x96148b811c0d7ea915e35748015a9d4e014b30dae6e2dc5cb38639b8f6d10e04a56c9fb2aa84f82e67b9fff22b846bb3
330,494,123953,215824461,2,0,32217258413,32001433952,0x809c740b7b7513f2d51b9f4091ce4e7c93be14b0,0x928a72144181e84abd97c54fa50e05faa579a08309d75f617efdc4c44a7b6cba4e5b4fd1006a1553ddbc1fde69bd4cc8
331,495,106481,215743389,4,0,64402251385,64186507996,0xe0a93b4f92c85fce94c15f365459c5fbb15f35aa,0x8e1ecb0f66a3fc404b45b61a47ae023e0f56c1037ed4787d4b5c370b55dad1fa18cc5cfabe8bee470b2cfb44a77d6fa8
332,496,123966,215726176,2,0,32217037167,32001310991,0xb72a1cc64dac54a6d65f38313df64bc19c2c44cb,0x97d3bc1b2ec6911f765df6aee22fc43947b168ca8c992ead4647f049bfc53aeda97bbf973c63e7c081dd8bf6d651b721
,497,123909,215687934,1,0,32217426670,32001738736,0x6de8f905b46e36efa2dca25406fc07d87e421663,0x905ae120f04d6f523381df61202838789fd387892ee86949c2b285253022866bfc3b6d7b879131b2ef49df81750bd5e8
,498,103872,215670624,5,0,64436582732,64220912108,0xf616959cfc26d7d734c28f4437d5b4d25af13b2e,0x8000361fee51a3b177526a5e16bf7add8386afe99eb7cc36117100ac956a6971da75ccf0ee76917f7200c487e06f4110
,499,123296,215654694,1,0,32222137488,32006482794,0xff6657fb62d096e48df19d3fac645b3f250b73ba,0x92a33707b976c3b2e3ac2d85eb40b86070bd6dccf913516d92781b31fa5db5ea4761c4796c451b80122169cb825f9fb4
333,500,123283,215644279,4,0,32219512213,32003867934,0xb4585cdf2423a4d3582042ff4e0238bae0aaceea,0x905c401dfbaafbfbe4c649e2ccc4a5348d31e1ea74ee233c7ae676b1428801a087970a677ed753e0593579b975f2954e
334,501,123051,215640463,1,0,32223436774,32007796311,0x2b343a798cff954f45097c52884658ebe1e23d38,0xb739dbd61689423d8621f7cbe69feb60c3dec4c2da568e3ab7148c7e4a402d3c0b2aefc80e1ea7472e104b60ec3fda42
335,502,123920,215628334,2,0,32217307047,32001678713,0x0dc8c6eab56a9568b2c5189a032140a1c5bdf928,0xa7d22be362b33c4ea24dc7e3cb15dbd4b3dc30efcea968a81a349f74e6d020d5b5bc0ae1920bf1f6cefe42d0551196c0
,503,123623,215610359,2,0,32220416978,32004806619,0x70b4e030b2ffbc1c44c7ee1bee17b26d34b167a3,0x8a1a6c4ac8dc034f45a17fde3b66c10b74ad23467b75ae59a7d57017a822ca8b1e49ca1b7649666d5d0b9f12c569c634
,504,124134,215595788,5,356,32215595788,32000000000,0x6d7abf9052a3e77ec751b4191f4ed1d626a48711,0x8e251f736432818448140a3678478b32d311ee4e8aea884e82d9a2c37d289d872019eb494a06a36ae5f34922053377ba
336,505,123645,215585961,4,0,32217756279,32002170318,0x6f64fce4528931de7f28952aba6c9bb617489fb2,0xad9c993b4a268b29abb7de7c9824ede165ab123332c169ecd3bb7fed97901879170ef5db4612c9a6a71ad6094e8fc8b7
337,506,123582,215575263,1,0,32220673011,32005097748,0xedf021c69566a907c9285426093a0689f3194e58,0x952c36d126a0f4c870281c489ef80678c5180c28f7ac332f6d1ca5b76be20c4f1c2e404c644c08399030afdc0ac7397c
338,507,123483,215566503,2,0,32221136745,32005570242,0xa95efed9f2e010d956b86870c450c69eac554c18,0x95bbf4e662ad7d1b6b6422edb4cc1f1eabd7a49dc7061134aa246474a33ff63f53c10718773b03038a4aed48c41c9bd5
339,508,123663,215560740,2,0,32220094213,32004533473,0x763ed99d798fa0b7de7e789ae5b4544618ac19bf,0xa7621f3671dfc947a431b80f913ee83b87f93069e570b05564e3932415bb1b424303b531476cff7f52dec4757654dccb
,509,123669,215553626,2,0,32228249170,32012695544,0xf8ced29d9fe13ae851c31b298aec88eba0d89ede,0xa873356dd1db5bccfbba8e1f567cd2aea486fddb2adaca6fc4b05eaf96883911dfc70681f68cc6c58ec901896c71869e
,510,124042,215491432,2,52,32215491432,32000000000,0x3c683d3547763ef6971b27c743187a39507b7113,0x874db734314c43b2da10c5e229739666a8f711a34af21ee1116e77dfb8f402c11936668beea1639f7c35353466ab1cf3
,511,123705,215485379,3,0,32211501928,31996016549,0x0a3d6563a62bb7bb32a75542fcc9ff2cb54f253e,0x94ada2dba31d968a48b93f9fb7e197ba4b503dffec157560857977d5a3d07dcbcc4b231ca33250716141d1480eda8437
340,512,123589,215379549,2,0,32220411057,32005031508,0x067b9c0e0afe665fb7b74af8db737b44a212177d,0xa82c5298125094d6c1eacb9ef088f99449ed2677de330e19d0233a477ec953500f3d1301fcf378c8444e422f91d51f04
341,513,123989,215361332,2,39,32215361332,32000000000,0x239fded3509ba28f1e46db55df1c2660b119a21b,0xa8ec403f09566f676644b62c6264aa010150ebc77351ca4631dc5cada5ef30df3ca8b9140371c6410e66712d2b19f1ba
342,514,123303,215348588,5,0,32221819272,32006470684,0xfac24fb0536ae6e7eab0d167004fe6abde04167b,0x828983aea4485d344cc62b11ca71ae94d5a4f0602a217ce0ccb440722e774474d32a9bec8be3044a43cb50063b98fd1b
343,515,105617,215303857,4,0,64433081733,64217777876,0x3152e8317483099fc8acc93cef709760fbd3952f,0xb8f04b4166136a22df4da7359ecaee4f448c278a29d7b6b6d50916d481093980f4b05a4b42b16c40a4143923dea27c2e
,516,106480,215300270,3,0,64401723789,64186423519,0xe0a93b4f92c85fce94c15f365459c5fbb15f35aa,0xb936c9ac205fb1618f5e31dc9dcfa7dbab5ead4a6f3aa89d3b5e6c9a97f89dcf98f5ee885d9b058fcf532d8080917ec7
344,517,124111,215290489,6,292,32215290489,32000000000,0x17e25693b3acb0539bf8ac6a405b22b24aa21b50,0xac80855abc85db39176d2ba18065be40d204bf553829569f38cb5065aa16039e4f05484e65df50295305a5ed417e1f24
345,518,123635,215280485,1,0,32220016592,32004736107,0x18cd84e101fd95cca018bb0fbdc81ad409813569,0x84a874992f81536b5a47185f72061480ebc15124c6c4088a8099196856f31768ea360bf567e7d724bf536587964bcefc
,519,123577,215243501,2,0,32220384695,32005141194,0x04e7ee585af66f41b346f81313488f77b30c2af3,0xab53d42db0168cf09a0fbc19f57697c6ba6f744a858d07912379159d65ba4809831cb7b68abbef085af08452cc4b56c1
,520,123578,215224888,2,0,32224082200,32008857312,0xdb945e85674f72571a455bc6a0190200717415fd,0x999cece52210b80434c1f6f029c76c230a59f0e3dfdfc0536de7cce8468c4b6af7b43c24ff1fb8ca64c55145899a0c6e
,521,123942,215218766,1,0,32216707474,32001488708,0x0477de2680e46af4278950f303291b0ab4a1e9e8,0xb0e22037d72a4c024f432427a58e5da39821684e79a7e38e8b220579b88e729d85c787b709247891cae40e887a13a9e1
346,522,123667,215125323,1,0,32219738849,32004613526,0x55a6083fe8c8652c339904ad9e285eb7050db3b1,0x8f8a0e99f9bb56a8cbd07a6d1c3b33ee86fdbda320ffa885334c42a9ce319902b0d72d2c38f247e68f5ee9b4fa175d0c
347,523,123621,215019803,2,0,32219860958,32004841155,0x279c892564903948316bf6a407e6f2185006378f,0x81fd49e75b98f760fede87d7434efb3c7f935834f2ef556150eff04e4a2952692019ab0ee9ac57ca4024a0a516cbbb75
,524,123321,215010202,1,0,32221266829,32006256627,0x5fb7e9f38011fa3b80c0b3a9fce835c2f749c025,0x87d51441b9ed52b3e3e9540dd45889038516c02b2afba8def65e89274af62bd2f6cab6011f436974680fcaaeec10aa89
,525,124199,215007231,10,554,32215007231,32000000000,0xa627aa20485342ca16960fd1f77c547801f7f763,0x81894857bd6e1f023d6731576fb4bc30391678d5e17efce72048d1d1cc56a84398b9dd50594d80731067e2eb6f91669d
,526,123609,215005905,1,0,32219957048,32004951143,0x1bae7de220f1b11a21bb681dcb320629887611f7,0xb7eb6ae25ab890366f239c1a66d0468ad16ca2cbe38ad3c29b1e9623a1298f83378971258871037d93ebb312fd009e88
,527,123612,214961395,1,0,32219752757,32004791362,0xa4f04a485f8560aa012beab69268a671c7592b94,0xa0cb3640a213861b720a373c0761ffcb1ba7c01fcb787b40acd1f81e2e770f7a50cfbba3667348e9bff8641c6114ca95
,528,123592,214948189,2,0,32219981812,32005033623,0x91928bf33a064d2199e52c28b0cef5569ad40691,0x85eb059a45ece8ea4b1091eb1fee090e0b7572c1e11ce31e36db0f50c66255097737b0f64e9636d81aa42ee92e26edbf
,529,123780,214882199,2,0,32218786086,32003903887,0xf4254a5f6a82474295ba01f7c0e4b0345c8be8cc,0xad4a8db6ec6db84672319cf6a2748c2248784bc8ea49e55124bfd35071e23b0fca82acb3a9288a2ffd7613c561c1201c
,530,123641,214881757,2,0,32219666542,32004784785,0xfa47787a63d326d7919b3773f4c32930ba1440d6,0x8a7b64ff5bf8f3fdfae3c5de33a44929aa4dd211efa097d15ee297170e26d5a873b127aa2de8b7a43ed7c0f870497527
,531,123046,214819203,2,0,32222763268,32007944065,0x724e42e83c36f5e23102fa8ec6352b6b121b8777,0x88814a745345dfe47e883c959d9320ee5656ecb5230b6d2be96045d243e3244d3a3806b38b71b10b58b9fae24eae8e4d
348,532,123734,214792064,1,0,32214761081,31999969017,0xc0554095ac6c9a76751442f09b780f3096c31cc6,0xa2bee3e2a5874f32d326946feac19d5325492681bb99d2f9ef179fa7646ba0127bcac2fb644c22aa00a2bc74ca6dd0d7
,533,123937,214785235,2,0,32216299580,32001514345,0x8686486f7505f63f61ddcd973a60938f3a1a61a8,0xb36651388dc7fa6a47fbb0bc9517516098f222228cfba2ece12f1da9ff96ca8b91756731052bdf2e0c41a2c8e797fa7e
349,534,123969,214762357,2,34,32214762357,32000000000,0xea886fa0b4205807f5917acd12fbb310a29aa82d,0xa88613e681e2e552b04554bb021da1eedb0f6cfe5ed3ed7454ec55b00543ef2f66a7062c78139377b9f45684c727742b
,535,123473,214691185,2,0,32220396331,32005705146,0x3d326bac04b67cd9f12ca40035bd2a770417e572,0x902f4e4f5b55886547b4621930b644f4de649a2fb212c44643cfd85b700416659f7fb43d9eb0519e75e4723c3d3c1ace
,536,123997,214688347,2,41,32214688347,32000000000,0xbb413d970d30ad1b6f2074a2413efde55eb78de4,0x9962e11790e6ff1ee0ef254d89a2efa498c90c37ea0fd9763672079961b8d0295e7afb9d975791be0ed92bb2ae6a939f
,537,123708,214654830,0,0,32219051928,32004397098,0x86ee3249b87edb65aa1ebd808a7e451d6ddff6bd,0x91c510398e2e0f36ed068aa07c2b0fb20c82a0848766401aa660a1370abef70e7c113b152fb0c112896203092bdf83e4
,538,123326,214479977,1,0,32220938481,32006458504,0x8701fd0cc7dde651d8e5a87ae6d2297b73d683b5,0x94b51711282d6712f76c4ac26cab388371fa8ca77b40edaebc53b6bed57770ae75574573f90ec14e6dc2e856ac9d799c
,539,123519,214478355,1,0,32219813062,32005334707,0xb9a87b4ace81415239caf9187995815673e234e6,0x85166c2c6b0769f938eef571457dbf453ad75a584e8426a03fc505e1d026db461296fb35eae4ae6468df8548156711b3
,540,123659,214476780,1,0,32219114252,32004637472,0x55a6083fe8c8652c339904ad9e285eb7050db3b1,0xb2576fa093027b1d4372b250e7ad09f5972bedae9976ec7927306fd372c927f9fb88f3b8cefed309b3fc0773ba278c42
,541,123202,214471527,0,0,32221262721,32006791194,0xb6d59f7c2e6f884f2ece7951e24107da5dddb4f9,0x87dc6ab5adff4b465ac63097123761fbbf5159a2eb46252df5f81d2c961a1686e2a75c6bedd00de749c8820778630279
,542,124030,214425503,4,49,32214425503,32000000000,0xc9de6550600624faccf1c60e3bc75b88162db4e5,0xaf0e5bb270d40b1614f13ec04b3a013035256bd2026c7c54b06f53d4662fbb415e9d7b64d1e338bd6702f711092dfd52
,543,123567,214341308,0,0,32219327501,32004986193,0x065baf0a6a153c70ea3557301d624b68352b6846,0xa4a336567cc085caa07f7a8b734facdd247295d63cb48015388009beffa8f80c4949081d37578e863f99967d12af633e
350,544,123975,214318202,2,35,32214318202,32000000000,0x7f8c31f20de9637007224633a1927bf8d0f07c5c,0x919b388c2a61c4456b57809a9ac7186598c72aa3b0d648614f81f977c58cd78bfef82ae704cd2a3f5ba07c3dd404123c
,545,123456,214236697,0,0,32219906403,32005669706,0x7e78228ecad2b14bec742af5507f102116d23e87,0x867252e672516518dbd5a578171a62127a0a1dbc5af4316e10a72cb2807ea2b2f476395d5f8f6d9fa98dc103fd47acc8
,546,121685,214202036,0,0,32234662577,32020460541,0xc1ead339e1a6cc81d90b533832d8c66a6cb50a6f,0xa3d625f2b4dc2097eafb3cc053abb968c64484bca7cbff583d43424ecee71dc173e4bbadb3e104bf7a4de4375553b28d
,547,123358,214125043,0,0,32220370039,32006244996,0x94d1162e18fea14802debec960f4d573af2d233c,0xaef6cf7849c2a2acfd4512f41de9b1e0060151d93c71bdcd6b0adc5ac1eead9ab915991b0579b7ac754d1f40942caf49
,548,123339,213985694,0,0,32220339938,32006354244,0xa2fc67f739604b00aee17b4ab95285b92a38ffeb,0x9261adc6e4da7fb4e8dde33612c4c35041daad626f94363cd684fd6e76ac8d0e62ce0687f74871029ab7b5f52881c351
,549,123331,213976723,0,0,32220361325,32006384602,0x34a708f8f8f2aca1a92509beceb22e5f028e1462,0xa9988fbd02fffe9ecc8bf1ec676cd0ab9a7bcbc8a7be1b145e4cee267ba00f38a59b1fbf5ef62f4a32d630ceec24d742
,550,123348,213959910,0,0,32220196312,32006236402,0xf2ef5efa034d952cab7ea7d70bf991a0254e4c85,0x806e981323104cf26c16b75fc9fe3a0329a6eafdacdb47829d17301cb58113c89a2357a1d23b17a3eed3abc0ca6ca888
,551,123063,213914274,0,0,32221724576,32007810302,0x481cde8a1a9de191821edd0a60e8ef38a433562c,0xb56c9de9141dc4efba4925e5b84a47e0aa91953d6a9c9ac2f613cc682a732852b224e83874ee2ed73deca5e0cfdc6604
,552,123762,213890235,0,0,32217911805,32004021570,0x3251732a8f790ba90af036984ffc3b63ec8c23b0,0x82c594e8fe288697e8aeec4a24ac834efe6b2d38c8c8341c95af9b136864f8f472d3e90f3d9ac34b8890157d9b8b5aa0
,553,123044,213868908,0,0,32221788486,32007919578,0x7e78228ecad2b14bec742af5507f102116d23e87,0x94bb15e74df3867c04937156fee3416c261f62bb8efa8713d1b41585a7fe914f9d5bd29df0924a4fa4941df6e1f0a500
,554,123554,213856992,0,0,32219041989,32005184997,0xdcd9b91e3446baaf3279561236ac903439e37a02,0xaebd53d85d73f2d726e50d77c7e09937436099021a5b97e5912c51f215e24e81c1fe7eedb547bde42893c70e64ae9ed8
,555,123342,213824848,0,0,32220112060,32006287212,0x3962b5e5f6a46eb1404bc78631ac8ad127c4c348,0x81fcc95f66ba80a155e9a8a2a57d7fda0a831a5cd11012e399b0cba6ce3ed3531b1d5e64b95a9d68459dd90f3787139d
,556,123332,213810214,0,0,32220183831,32006373617,0x9a1cff839360f693d463993bb4593cbd241169ba,0x812b56507e0eb45f4f2546bc49faca65d562b15119248bd430d4a26e314a6231dbf451f92d74aa7fa2a62bcdb8a7c5a1
,557,123700,213791629,0,0,32218176451,32004384822,0xfa624c702be4e502410b2cabfc7a9a574e130f36,0xb03b392a12e767dda2f351a55769d49ffe6490985502487d582e2bb523680c462fbb97584286aba753ae70ebc6301d7e
,558,123923,213791351,0,0,32215479115,32001687764,0xe1eadee0972f1379a32c3635b27bd44ed15ab9a6,0x992352dfa0f243a56b592acd830fae22872cf60049c72d38370a660917bde5a50a5faaa10ede1ee5015741a726b54e1c
,559,123550,213791233,0,0,32218885535,32005094302,0xb8db2748674511b86c05467909f46318b4e16f7b,0xb9b625f97ceb3fadb89c7f6c8a0505d02164290845a593132813002b73ec58f4a795addf01078c8c704677e339304f69
351,560,123652,213783443,1,0,32215881531,32002098088,0x5eb4fe51b146b03bf7b0593a184e558d9a418719,0xa576cb1343a9a3c67978300e5a78133aea1c1c0b0f936b98faba4b7eccdcd1cf41e31fae9b6035df3d9ba196607da145
,561,123756,213771046,0,0,32217808115,32004037069,0xfd15ee7a39d4e2b6aa00cc9f1038179ad8e760bd,0xb4b5f21ca1edbb3862cd5067316fca2a91fc7960fe918932ef8b4d71eaad6e4097b335d3f46f404e34f0d6463e48ccab
,562,123815,213766135,0,0,32216148960,32002382825,0x8f756a83846c54ad75d445dbfe72fd76d27816db,0x917fe864fac31d26790175bba424f07adb96af1a6ac78864e5ad4c43dbbc0779995a7d4c0e9dabbd6f151036dcb11d05
,563,124094,213763513,4,227,32213763513,32000000000,0x7bd0ec5f106c4bacaa87038a2ed8805497585f7e,0x807eb6fb6dfcb3cbf226e619d7a2c11fb3f982380e86894ac49d5d5aacdcb6a0fe288bcb6752b5e4b810c0bedb93ab19
,564,123935,213758277,0,0,32215297471,32001539194,0x57665202b06202e575cd77a2428fcf039846f1b6,0xb29199a98dfd65517b5df36e6fd7aacc9f43e66338b214ff7711979ad74869fda8458ba2f409e4cae4f64b11a4e08b50
352,565,123744,213754297,0,0,32217910493,32004156196,0x383016480adbe9fba2391ca8da0646f8cde09136,0xae76c70992cd3ff27d1bd65a8dbd2d58628a560785f90d2ace30a9b71ac1e4f17e540bb263f2bd296ef78a2202204e57
,566,123879,213705923,0,0,32215642910,32001936987,0xc9e1e1a5d0096276c53115eadcb3921b216f039f,0x8f9b6e6409e9e2ae06e69f09ed43470560206fba53a3fa58762837f2fbfa6d4cb372ecb609b9c063ab4b8bb55463c4b7
353,567,123452,213655538,0,0,32219431899,32005776361,0x949af0972f20fd2d1c0e1f6fa85ede350c46b851,0xa7498d96bc305801651b09eee817dba0fab8849d4b664ad77192f71098162e6ff024f8938889bdee0ab3f2cc9aa14217
,568,124150,213635565,4,360,32213635565,32000000000,0x866de382f837e7f3b4a42440ce1a396a88407c46,0x98606df15a2c7686b356c51ce513c7507ffdfdc13b95bcedd9c6ce1b9f11ff34bf2b550e908d0efa5e561ea903778601
,569,123071,213605165,0,0,32221518393,32007913228,0x402c049b925dd377a7bb6eb81ec2ff936fea1313,0x8e0489e25190aba076e41e41252366691473f5531f1c01c717f2ce5f5bcadf0ddebd39067a451387a082ff5afe28aa64
,570,123921,213571983,0,0,32215204865,32001632882,0xccff99c4bcf4129ba65b0b464bcc82d59eb003bc,0xa50c582109d7e0a83891ddc03cd0e1cee03a0516935116efda875690e263bcd79598e8b556c3dc87f87b4efd77e7aeb1
354,571,123715,213568482,0,0,32217921850,32004353368,0x50799e0098c38d34c9cb1f20e07670a7f1d64a95,0x935f364c9cf2e9803f65461a231f714e9882daba55d615cc98c1b5fcfc560ef3a458d890b6132ea0e93e248d05f2ca85
355,572,123069,213556114,0,0,32224495360,32010939246,0x57e7ed3da18d30aeef02f35367dcedfa88b567a4,0x8d04e490a7959759987b7e915150c873483799e43aa6ae7e137bcd27bd630e2cec9761c56eef555911f97c144c7a3bd9
,573,123413,213551130,4,0,32219276823,32005725693,0xcb64923781ee85e71b85ae5953f30abcc22b87cc,0xb4bbaf801ff18a5ea51c19c475625f550756e95277c3001b9e036c1cdf684e3d887b15d6fdf956595e76bf14fc9d32e9
,574,123573,213547878,0,0,32218688820,32005140942,0xbdc3b1550be3db6197627b637da2e2f7b2f198f4,0x8c1ab88de7c44190da520ac43a0e7899d179336f480767a2c0c65eb96d5ad7f496e5173e94ec32cdcf73747e0815aed1
356,575,123093,213515212,0,0,32221215649,32007700437,0x0f7af64ffcdbe3af1fb9bf55a25655ea0c69ed02,0x88c49b56d60e4b0745962e95fe53f8664b72cae5eaf138b3b2fe51b80ccb1dfa9dc5bcb45a03aad1eeb5387b22ed4c72
357,576,123687,213505651,2,0,32215391809,32001886158,0x93f09ac607122765e3c4489c2d63912b6a734d68,0xa4e97152ed4be4387b8eceb10d220129b00857037672905231c15bd95459316f05c9d932e3ea64056a68429c8bff6b77
,577,123317,213499097,0,0,32219980273,32006481176,0xf2667438a7bcec847ac58c4ca6fcfc68c152cad0,0x8295c3570fa31f4ff74ab6d9f34462c233764c46cdda8b066e6a4f33f1e1ba6e0b6c1012beb4b3317101422176d50724
358,578,123848,213478165,1,0,32215656556,32002178391,0xafc94d0ecc975180dffef2b41c258e12e152b7cd,0xa808b4b677a73c45eb35c267b8ce11c3c21d35f8ef97f343ff16842c1f09d5c294882a588021fc0b0c1e88512c71b75e
359,579,123599,213460268,0,0,32218497564,32005037296,0x27a820b66356350bdf20dbde380c53b3bfda28ee,0xab90c5e35ea304665b0994062f19e5378b253dae44ce438a71ea00792c4db9d8f9fcafdb1096b51d59c8399d318c52b0
360,580,123693,213441369,1,0,32215477506,32002036137,0xef6f998c4687f3ae3989271ea7f6b86180c49779,0xaeb56a37148fc83ce0f3c1f31accea112d419682a82ed62b457551d44aedc8cb9e5f846b43367aa81db97533aaf7a7f3
361,581,123691,213410201,2,0,32215384705,32001974504,0xb173eb5a5792c17f42c094da1c34b1b01ab0b4a9,0xad362b64344e976992da833bfcd5811b33291db8adf5e28987954cb332e6424406ebde918d1334fdd7e8f4812f82d70e
362,582,123694,213391903,1,0,32215399081,32002007178,0x8679462e291d49265cf985ad94674a73fc53c43d,0xa0b1deec6f1310e2066090b6313baaf808c3c707e2f15ef69932516271a56e296682a69f9d0b580b93a684a5d9301cb3
363,583,123681,213363245,1,0,32215258951,32001895706,0x216795e5bf59929bcb25f06dc84c93f89e24bae5,0xb47d0c47367e8e28f4a728c715c8318551b845e234918b9ef5596c9e84173428b1d7aa7c420b5b47a4205aad46ca7152
,584,123315,213334917,0,0,32219800471,32006465554,0xf2667438a7bcec847ac58c4ca6fcfc68c152cad0,0x8a4ebb3903a59882bd2aaa788d7d378e3f444eda7a2e3be3f2519676f131afe8e4ef334625ee089a3992661fbfa07930
,585,123574,213327877,0,0,32218295669,32004967792,0xb9b3dab26083321567cbe18a73b257854f10b187,0xb32dfdbeaaf99a143194c240958efaed973f6bf5f43115fb0fe39370bd045b0782f461be6672279f747203a1289f94f7
364,586,123853,213319329,2,0,32215391357,32002072028,0x0fd6f3f54b64d8be5b0846b6510ef052ca79ca47,0xa4cc9d9a246d2bd075bef6399f4a1643ab73a93d9a5ff4719c9a82eab43f70219149e1b31e2e84e0fe1025af24100d0d
365,587,123274,213282455,2,0,32217001846,32003719391,0xf6191248496c602f34bdebc163a728bec03ff8b6,0x93398f479d7d051c5d478b3ffab5ac0e9ca9bdd03186adaa02a2ecc4f9832b618c95970dad6831b820cece3ffe8c6fd2
,588,123415,213260839,7,0,32219121949,32005861110,0xcb64923781ee85e71b85ae5953f30abcc22b87cc,0x87d26f56f19ba1318cda695262a257b4cb120e2ab8f5ef68fd8ca10f7eaccc0e4e090f3f195c64df69d85008d6eb42dc
,589,123085,213257153,0,0,32221047956,32007790803,0x0f7af64ffcdbe3af1fb9bf55a25655ea0c69ed02,0xa237673f281a47293a09ad6872c29871e70f85bbd818d535a09be8cc69decc9f268eb69074b185a15f074c8d479734fa
,590,123228,213255908,0,0,32220010513,32006754605,0xb9c3f7db93c0569cfbe7656092ac76d0bdbb9e80,0xa7bbd2e4d6970194195a6bf7fccee6462ad4d4cd3093b568c3f250e4c32d3051eb44f31e6559ae144eacff6f97fc1671
,591,124237,213246119,6,626,32213246119,32000000000,0x724e42e83c36f5e23102fa8ec6352b6b121b8777,0xaceddb77c2e4c2ffec0802ee49efbe96611fd4c061b7c174486bc7389160afcfe5bd35bcc0d62e57ad62bd16b34a7230
366,592,123282,213233544,2,0,32216899123,32003665579,0x29a83157a4bb42a507e7946e6df94db98824072d,0x80cd0db17f9edd31c1b1c797e71256a09720307228566649d935360cc537480ceb453a2d13d0572cf6d7bbf3c368fa9f
,593,123988,213165786,0,38,32213165786,32000000000,0x818b317357353dc58a85dda8b0028d1b4b5ba3f2,0xa425b49d9cd5d38a08f29bafd89deb00c35c946cc4b55d2132ad2b5fe4a1b1cf47b02f040a02332b579f041fe579a36d
,594,123077,213097466,0,0,32220604499,32007507033,0x4977294a902e2263a6d7c58a839f5cb1160ea259,0x9682fb88f3648a9d29015baf72d480f00cddc61d8669d87d570efe22d725ab91e700a0b157f4f0fe873c5696d7f63f66
,595,124068,213090794,6,170,32213090794,32000000000,0xa09aacaf98ba261026d83f5c47d6ec543f128280,0x93dc8b1f0ebdf61ce81a9e0e9e3b5eb549779bf2f3b43aee51118dfafd3895fa940126aaa39675d917799f3fcab899a7
,596,123535,213060715,2,0,32218446121,32005385406,0x10f46e6ec9868a2be3dd2f3bea0d5a88b06d5805,0x80ab8e0c792e292bd30a71e2e40d3ba5ca6e2d625d5776ca6a3b7435ac2800a8afb3d2391b290fa98ba9fe13a20e2a69
,597,124062,213030766,2,168,32213030766,32000000000,0xb9a87b4ace81415239caf9187995815673e234e6,0x88aa0349e03f0821dc0fd6f9af41ce90ce611aa63949a730da9d007d1cf408c63b0bb2d33da8c3d594d6215a3b12d589
,598,123252,213009150,0,0,32215836036,32002826886,0xd9d9c4924dad181b5ed93e0e9850c21435e9e0a3,0xa2086f0f442a5c02ab61950e193dbdc01ae563660d07ee5d79441cecb86baad688288ea04c7639127a640d1fdfeeca59
,599,123417,213002490,6,0,32218771048,32005768558,0xcb64923781ee85e71b85ae5953f30abcc22b87cc,0x850b9c3de3ccdfd9cfe7109adaff7603dbcb75c27c94ee220c1bef1fa8506bb48be25e171db522730e83584588d49a88
367,600,123278,212975577,1,0,32216653655,32003678078,0xbbef812168a7ebff871f827b268bff96aabc8425,0x936aaae1c2f78ef98dfbaecbd6c513a585556a9e8f918ff9d3c87ddb4fec8919d6240444b0049895066a1d9313012916
368,601,123688,212950862,2,0,32214939018,32001988156,0x5f567c0f7bb354aeb55401e7717038f8b17fb9ad,0xb18e046f1bd3364295b033794402f844a11c933c5c9b0ccdbf925b921e975a85c1972eaf0f1170dcff55b86b5da2ddfd
369,602,123255,212917527,2,0,32216664865,32003747338,0x3b8919e09cc8008d107eea90b2e7eff87c9de764,0x81a96e880bc64e35d9b5f8dc077aa7ca19d44aa707a0a304fe969c7d263875f1620a9a23bb78819f7efc27eef66784cc
,603,124043,212914491,2,164,32212914491,32000000000,0x573b2c5d03a5d6436cb058f9b4abcf7bc3fee55f,0xb36f91418e6c9aca72f8e72c801d815ea9a4d09df979f9ebb2baea79021b39cb63944da005015c2fba6309b4a5679c90
,604,123435,212893018,0,0,32218882695,32005989677,0x521deb0d352d70868a6c3952b3bd478f11eeffcb,0xa6059f02d523c5706448e84bed962133b9f73fe7b547405f0a2610a63e42ec12e04ff23acf5916a1ce1c86c669f8fdb5
370,605,105596,212876547,4,0,64419186118,64206309571,0xcbf2c50f7e75a5d6061e48d9b8d7b501ff7e9d2c,0x8a2f60a170e9903b21cbb5c260fa8461bf2468d0202820bc83e053fd8659a0b69adeb740ba48aa00fa2e4ced4b2dc5b8
,606,105344,212855503,3,0,64404147892,64191292389,0xc0eb84422ea5691b29f99000a84bb18636e27471,0x979b80cc317e4abbe582597a5153c4d624804204c36d9cf1de1e6565c61a4a99d20aa671d03b415dd8034f512da07448
371,607,123618,212823574,0,0,32217727569,32004903995,0xeaa7711068a3d3fef958f801b8501eb9d83cd2a2,0x98565979efdd4dc4cc02b567e1874aeee7b2589e35bec89d33b9ddd1bef9676f98e2c131125c442616468bcf1fe95077
,608,105616,212808059,2,0,64411827356,64199019297,0x3152e8317483099fc8acc93cef709760fbd3952f,0x861b67fe1a75a4c3bab39a2cff3628698ab66e7a59d57c220c4fad050d5edc727b23ad45ddb4b32a5db027a56bacd2a1
,609,124149,212798657,1,360,32212798657,32000000000,0x866de382f837e7f3b4a42440ce1a396a88407c46,0xa0b39b2031bfe7f808eddcdf779b78ee6dfc3568a758577beb39be06358f869546f332b11064899ed44034a300f0e7c2
,610,106466,212790714,1,0,64407745645,64194954931,0x6af4e87b398c0986d81ccf59022bbeaaec2f5367,0xb353d4337449356557591dff750d526d308ca5d9154bc498b94b57b600d3d1b7bd0fa6a164dbc62b97a349e2630e446f
372,611,123653,212741470,1,0,32214852946,32002111476,0x30b7313af419dcd7a570b1e68ceb4de360c3ab07,0xadc1bacddfdc708048bd0d66720c7c63e78f4d4903aaf10f440db90ff862cea0c5d812871f2f69edc3bf694d4a308fcb
373,612,124055,212701246,3,167,32212701246,32000000000,0x511e3c306524a5c4cb566d3309e8d36ec7c7d8bf,0x87a9d73d2d3195dc5d224f0418d5b0a54052a4942cb17116255711c0ffbf630077dd7eb235f0641950db98b89d434406
,613,123962,212683689,3,0,32213961667,32001277978,0x75c8c9e5c64e9830814446d3b20b71ce3d19a21e,0xa617c445cf68a4ffbfdcf3820e3f2e2bd393147f27181013258c2ea086f7e517ae3c5e55f4e47e4b8afbd31b3b9e2197
374,614,123685,212641032,2,0,32214630255,32001989223,0x67aca7cb6e80f1ace948102ed4e585ba7c83a8b0,0x93e58e4a9989fba1e0d9c7f19d1f952965eb6319fc4b9aad6dc9e03a7852d0412705a70afd87f4c696a36000e2b1b209
375,615,123512,212623671,5,0,32207458736,31994835065,0xc7ffc28142ec9cb93d1492ed2b8057d0f2b12fee,0x8270337b8847b1a35e8b399dd605f94328d43af3199f7c5f8af1bf2192dbf53e32287da5268e2a5f6f9eade92d646046
376,616,123998,212573441,0,41,32212573441,32000000000,0x0224a60ed78285b2fbec846c55da9114a8379376,0x9682f2e897f4fb590447acd1d02a91566e857820c9b575ba2233ecba8fa3182b08c5efa2610b8e4ae5fa28c477141d29
,617,123999,212572083,0,41,32212572083,32000000000,0x0224a60ed78285b2fbec846c55da9114a8379376,0x98b4788b099d254331528cd65e647063de2c81908bfbd4829d840c2de02f2f9c8fcfa904d0fccfdd5f09c40809d14157
,618,123444,212544599,0,0,32218342873,32005798274,0x6e158a6f6caee5fff98f8fd3d2d816a216ee739d,0xb0da01c6ea7c3c9006170328396b0a63e0a1d3d194adc365fa80f0222e844c585cf31aa7ad4011561e9b0ec4d2551391
377,619,123287,212536213,1,0,32216236022,32003699809,0xf2497f5675159c835aa41535e50e4e0025552d42,0xa4e08612fee9430ecfe7414cb5bb1d1370fb705f7eddcd48430bbf0768993429ed335337620f22387969e8ca11062e9c
,620,123617,212519629,0,0,32217388024,32004868395,0xeaa7711068a3d3fef958f801b8501eb9d83cd2a2,0xa07b9dbc9e36edee26ddde16a6bc610bb47f374482f32acda54968d9afe2edbf09d6d0f1701260566237124891d15663
378,621,106476,212494144,3,0,64406651926,64194157782,0x4c8f048540eb562056c1831aae2241b093b927b7,0xada42f49aa34b33e8631e7b4b3ac93be2a39d10dca708daac4bf03d61ac04edf31bcaa5db99d75279de3c3a3cc0287eb
,622,124069,212491874,2,170,32212491874,32000000000,0x949af0972f20fd2d1c0e1f6fa85ede350c46b851,0xa1717d0eb58ceb5b0831d45f037f28208fa216bf1c08c4d3162e3be4816f3fea5fc390084f8888e5cd89678da41b4d8e
,623,124061,212412045,3,168,32212412045,32000000000,0xb9a87b4ace81415239caf9187995815673e234e6,0x8159222c7c0794cdcbcf10976851f798b29ce3356311952466cd73f71caf3da5406c1933b0608a041635a22b4e505e4e
,624,124148,212381667,5,360,32212381667,32000000000,0x0c02d5c64f40fcfe10bf65ee900598b6bf9f8ded,0x8484cde0689bba039923125c850ca1a5eeb58b5507fd4b93d5ecd6c0a661a0a50bb24e10c70f998da6fcd19b96b65518
,625,121564,212355858,2,0,32239906706,32027550848,0xb4c6b0bbb950be7d08fe577915c9d40df43557be,0xa1e7c016e0b4abd9636201d27c4341144248397a5cefa5ca1be59e13632bf48c8c2d59c74a5431da5e3f625cad2b9b1a
379,626,105405,212343705,4,0,64411576171,64199232466,0x2404f78e82cb8bea3bc59a34cd5fe6a9b2e400ce,0x8a4501094faede6c716f08c68723287374e4e2d124c84943e505e2d6f20c7573703c79ac5f763f4ab8dffba31c8812d1
,627,124059,212316081,3,168,32212316081,32000000000,0xb9a87b4ace81415239caf9187995815673e234e6,0x9593ca96ac49702ad2541c5fae945030bb88efe97bd4dc0c7daae99bc689da319ece262e443d6ebac4c88bd41bffab1d
380,628,105423,212310629,2,0,64411030147,64198719518,0xf2fb9b2c9aff9b554ccebad86a2ce63cb3f24bc4,0x8a9da1493caf09c0a8a0436aff8106d730fe75851ca5205895249bddcebb836f069eae5e875bb61bfb48014d57e6c972
,629,106477,212300356,2,0,64404705675,64192405319,0x4c8f048540eb562056c1831aae2241b093b927b7,0x8d50368b325dcbc8026d0f0b9791983f70daa80d7fcd76076257a53002339544e83453f7ebdf3bcd630742c671256470
,630,123614,212259224,0,0,32217188281,32004929057,0xc66d8caa717e86954f2081db0c325d8de432f2d3,0x8c5b5e7e456c54d2564f86f07c163ef35b861ff45fdf2bd7d028388f6bc39385f2f1f1c028f50b4faf94324a09f03e91
,631,123633,212249632,0,0,32216971773,32004722141,0x18cd84e101fd95cca018bb0fbdc81ad409813569,0x8e5e6d8dccae8ee9586d5218a39cd2c320bc21db7944e0c6c244d578e1253ba6e2b75d07c0e8835086fbd1ed398b5b23
381,632,123281,212220059,2,0,32215891012,32003670953,0x802464e4760c52a1a75e9a85a8b54664483b9f8f,0x9699f39fd472ffea0dd7b098601bc7133e1f7953a0d47f55cd3af77d32316c3e71026036dcf7fdf5e51b6b926b7fd5b4
,633,123486,212196000,0,0,32217780650,32005584650,0xbfefab110a22ec081a6406eb29c3b2491414a099,0xa48c91fb24573e4ee083558c2b20a17ae00be8b19815204d75e613219bd19f6d8decc67e94f8a58f7a9e6e5f3803a0f1
,634,123665,212176272,0,0,32216749658,32004573386,0x63d9b20befedb5c61ad5a158e68c0626ad67826e,0xa7e8a6b4967d804e0cb1fb114d15d074662246a67265929430c8930be51c17b1af5164025383cf4e0ccedb16841892e2
382,635,106461,212172945,4,0,64406833192,64194660247,0xb45565c05ff0c123c738aa6f6fe6db5cba787334,0xa25a6c09a0f46382af6017365fffd32cf37a1cb1b88c137962b049e5162cb0e11d203728e4ab03dbc18176ccd267e0c1
383,636,110676,212149744,0,0,64705874701,32493724957,0x3c8f76a90081967686c7627bbba68b0d4dafaab3,0x8397a31277b483408dc67a7f82783ef5ae9daa56c30421a36f973c60e921a510355ca4743609254844413f5bb3c0a7d7
384,637,124196,212141596,3,553,32212141596,32000000000,0x957d007b3371b2587ea8fecd85dd7dee8008e461,0x8c0d0eccac592948891d49aadd638cf5053429162bcf7933cc492b0e4cb5654429b2371f2a95338a9cf4b29624929983
385,638,123442,212141402,2,0,32217884448,32005743046,0xed9422da0c15782360803b8868b0777ececab111,0x989bb2b1f63979ea16c04ed2bb36807f00ce3c4f51a8edba4eabb31a8a540f1b1ed724e558f46b40c82a492a346d63be
,639,123306,212140697,2,0,32218503841,32006363144,0xfac24fb0536ae6e7eab0d167004fe6abde04167b,0xaa8f9b3d109e6549804e10b77244c52a6e858d15de364b0f1adfb3d8946d7168351cc89284ceaca984961162d31b731c
386,640,123075,212030395,1,0,32224600407,32012570012,0x6e1c2102f37d82bfd1c4ec1ee8bcf36c4f1c3346,0x826cbdad3d797673a1b7a14029e1d42eff15dcc3a39bffe2b647466a5b34c768d79c1f868b4d3d9971c8d59819a6916e
,641,124050,212028918,1,165,32212028918,32000000000,0x50799e0098c38d34c9cb1f20e07670a7f1d64a95,0x9362baf0e92aab9ac690ab13f43dc3f343d8f28ce6948c71e9598c8cab123f2072894c7f21a622044b0385550de88c50
387,642,124229,211993505,6,624,32211993505,32000000000,0xc8a91e68821cfd4c63a3c1ba4a04ac3eaa79ab18,0x8c1fae5af51e2997ff828207fb9c8c78dce15e8a86144ece9737dee500e754f0b7d5ef64f8fd0197b421a556347544ad
,643,124017,211944509,0,46,32211944509,32000000000,0x24a8116b077631b489e6e8eb43a87420f152c79c,0x8bacf3808c841bf4b5da3ad74e2a93e35954630f03f7c3410a1154a58557a7f68646fbc49c19236772000111c11c0845
388,644,123626,211937301,0,0,32216821864,32004884563,0x06f93c35ab06d154de8564ead781f2902ed66e4c,0x8d52f40676823813e66a0d18c9681e4973d86700e65c4ff58395e78b908662f2f2974fb9d7c9c0e48763902db8959f39
,645,123561,211935260,0,0,32217050903,32005115643,0xaf80e88b0d1fd57440ba51cb48e5e5329428b785,0x888f43c12fc46d9b748859ac770a3dd1735dc1ceb56b3e1287936dd8666c5037f12d41c522c3b16256f07590ef23b9da
,646,123753,211934209,0,0,32215909213,32003975004,0xb9313f94607be76503b4fe36f261840c6aead9d0,0x973573060e31bb851b76848ad9d61a5bb7ad9da1ac7f69bc3c66901efcc8a6a4d41ad490253e9a846bbe5d3e46eb6faf
,647,123584,211928946,0,0,32216923356,32004994410,0xedf021c69566a907c9285426093a0689f3194e58,0x85fa079d4e39344c9c8747475d6bdde0bed0902dcfb8ae81725bb4379b83f97f967e01dc12f1ebbafa021ff4a340ccbb
,648,123593,211895053,0,0,32219869681,32007974628,0x067b9c0e0afe665fb7b74af8db737b44a212177d,0x85514ddaa986fa619a17694872005f211a95fc8d3d9eb480e4aa336336bde8506d9295c752c84e36890afe11dc78fec5
,649,105618,211877066,3,0,64434779048,64222901982,0xa7cc52b7598c43cf56ef34fbd477a333edcc8238,0xa0856f739510edc7aa195fa087e56cc21acf4c730dc9c46a2bc86631935e55b2576c88883dcea5a421deceff109f98aa
389,650,124156,211845915,4,422,32211845915,32000000000,0x8b62cbe635f3ace0521015af82eacf491a862d92,0x9150b6ee69c8a6e10ce0a168fa77c7845b54811c1d2733d0b64a986e2fce5b7ff6808a185b9623070dffdb06ddcf2cbc
,651,123738,211825365,1,0,32215977510,32004152145,0x373ac5158686c025964b1e5d37755fc368304e54,0xa6b6607cf4a8c172a493601b896feae887db65be818cdb6f21d5ccc68d40eaed7fd41bb42a9238f2e3ce9689662c5f60
,652,105424,211811924,3,0,64418256161,64206444237,0xf2fb9b2c9aff9b554ccebad86a2ce63cb3f24bc4,0x8a6a927d316b32910e710bb364839e0fcd709b17f6368c6b6b5d24284b4a1824b87a64c5d1d95dbc95f10f4147878529
,653,123620,211750540,0,0,32216561277,32004810737,0x06f93c35ab06d154de8564ead781f2902ed66e4c,0x81b5223fe1334e3920f9a5894ec0308e9bc4e7e351278dc142e2799d1a8fe83416a1f1c232404ac83687b63801ff7e20
390,654,124143,211747390,8,359,32211747390,32000000000,0x8fc668c95c1980e8d1a91734382e0b39204adaf5,0x937e0b50c35f02aa33f1fe462cde5fbeab3091f25c9850ce8de60a7781b737f80e2b07ff4c4e94ff5cdd2479c250057e
,655,123630,211725341,0,0,32216448014,32004722673,0x78f73a75c089790865e56d6811f6f9820d8c7715,0x8977784c1c8519ea9cf1540c591fd7a28108e9cff03cda21d54bf432b79c03262eceabb55ee7d0916a152cebd3bbec67
,656,123657,211700138,0,0,32216326462,32004626324,0x763ed99d798fa0b7de7e789ae5b4544618ac19bf,0x8e2c3db6a523cc065405d4edc58f3c7286937fdc954affefa074a2189020a3967239e8e6deb6dc64a71855583cdaa760
,657,123464,211636713,0,0,32217321250,32005684537,0x59ff430222fd3fd428a001fad3d7b1fc5c0b0e24,0xa20603d535e4a57fd58a6773804947b9194c292b5ec8c99ffd967ad038aa39fc3ca52876c3772817d68061a13bcfdc56
391,658,124178,211609139,8,549,32211609139,32000000000,0x8d6b61de69358cca25fef4b7f583bf3ca95a373f,0x83c59e336ad1af3de7bccc938b418da61002f7ff34447fc313bff0a510f53eafb5f50a20a9003f53ec2ceaa810b1652f
,659,123192,211480277,2,0,32218502045,32007021768,0x0fc7f2b309328529b2510ecfe2e903e75b2a6d51,0x83ab9febf05fb248f658170dbe81cca252c8ec5512e094984c64f53a69ab8214493c97038121bd4050557983dace3a22
392,660,123218,211438064,0,0,32204140956,31992702892,0xb8447ae2a865edc14f9529385884e0612400d15b,0x93bdfb6b1bc5ea898cdb0f933ca44a47555f2e26c24236d37ebbc43a7f7fb5555fa011cb14a5ab1bc16d431a3446a5da
,661,123624,211372783,0,0,32216251649,32004878866,0x279c892564903948316bf6a407e6f2185006378f,0xa317e68d0feb861c397f6b9e73cf36ffeea555a76259d6f5ec4e96f8149fbf9375e2f2fde125060bf9d148b8fc45653b
,662,124192,211364056,6,552,32211364056,32000000000,0xd974c75f228390090080801675b258c043032a46,0xb1e59f390321280e998bdd9ca06de0c89610d0712a1e7e4faec239dd8c3c7e9db4783104deec3b02a06dbe50f28a9b6d
,663,123307,211334688,2,0,32217801783,32006467095,0x08f51268b26a7f64d5e72e2c1f391ac2c526d836,0xb1148ff32265e79ba50e5fc701cbb78b6443f5d7e1dd3c211aa2444a08e60295a87c7cc88a86a7026e77df7bc6b4f953
,664,123421,211203507,3,0,32216860748,32005657241,0xcb64923781ee85e71b85ae5953f30abcc22b87cc,0xa5072ec96ad6995772fa2b779d7bd5746144794d3a9ed95cac00fd5dafdf00a73bee55e6530acda9de58fefe25230e98
393,665,124119,211161714,4,294,32211161714,32000000000,0xdb12f73f7301c1efd1c8f468a187901507bd72ca,0xa18e975c412dca44c8992e20982f08cbd6f9f44488dbc08b04adf6400cc68b717a05d6f6dcf45522156cced3a0bd4a03
394,666,123598,211085835,4,0,32216088986,32005003151,0x4043c76cd517b0de74d58fe782d67a56501162da,0x8d5a191a448f663338d03d867dd5bc519131cff6cd38fad7b80d604e1ecb6f0fb1756a44c9b68f20194ee0f1026e570d
395,667,124018,210990589,2,46,32210990589,32000000000,0x24bde324b104db032f42905562896ee51de366d4,0xa63616a76248ad1bc43ff8be0ff4197d094e1c5cb535e1d5bb10c9727bdaa343208277c26da87ebd390be2d30102b4a3
,668,124100,210979412,1,229,32210979412,32000000000,0x0cdd8368c02b465945af76d3e47ee7d48caeca4d,0x94be8f000d2263b93fbd52898b0c3dbf255fa454b0d0eb29128ddc140532e6d6a3fae2c1092cf09611b6dfd1d50560c0
,669,123855,210939871,2,0,32213067807,32002127936,0x0fd6f3f54b64d8be5b0846b6510ef052ca79ca47,0xb6878f835f9bd57eff5c97222917e0dd3a42056a9ec16254b1d4c9526b72b70e6e25f3b8d126b044e68256aafc171e11
,670,123985,210737992,2,38,32210737992,32000000000,0x25a8f1d68f352838a8188048e1052476934a2efe,0x82550bbb91f1a889eb2f69abaa45eff9dde903f8eca584688e08b1842a6800847184c17ab06edbfc6e202184e5a7ecb9
,671,123416,210609551,4,0,32224095436,32013485885,0xcb64923781ee85e71b85ae5953f30abcc22b87cc,0x92996f6461200e4560a3a352ea9f2e544713d6d7c4ec83f52ca7014ff18c61d0213abf2277f8029b019bd9e57c740eeb
396,672,123241,210515286,7,0,32214940245,32004424959,0x1a5ca4f41f2473689f69e3d082ef5e2585205640,0xab5ab444c3f75151199d4660a56bdb1a92725e01e2c8aa2a43d9909b884bfaf8eb08c51206c142add7c2c20c998f80f8
,673,105404,210404621,1,0,64428192071,64217787450,0x2404f78e82cb8bea3bc59a34cd5fe6a9b2e400ce,0xae8846688380a40eeb00c28bed93d062599c8f564502f86d492c73153e84eb7a18903ed9dbbaa15cf2f3da2faef12709
,674,123411,210392551,3,0,32216344673,32005952122,0xcb64923781ee85e71b85ae5953f30abcc22b87cc,0x929b0f6bc8b9f4c13e94341b00e6190380d055ace2523b05d009bc896210bb763ad5d58c11153c5b1df12c8bcbe95640
,675,123800,210293295,2,0,32212720141,32002426846,0x2c8bb4f561597b47f0e2e53cbe45192fe953ddcb,0x86a5d03974e143f2ac324e52b9015b3d0488913e695e512db476a33bb432047a49d2e6063500da7d840330b7106318c8
397,676,123670,210280313,0,0,32212209979,32001929666,0x83dc3e3e7c9ea42907bbdedfe07bf0c4885b631b,0xb334724aa69c1b884f5706c6c4489bde6dc9d9906864aaeb93f609956cfdb343b5f78e277290b5d810eaad32c22446a7
,677,124146,210268570,4,359,32210268570,32000000000,0x481cde8a1a9de191821edd0a60e8ef38a433562c,0xb3492c7f2c5ed6b074ee92f2b26f7d676c03ceed92619fcf44fce06173e83b74ec459b97fde867c72f6fcbde42049cc1
398,678,123832,210188493,2,0,32212375787,32002187294,0x15e96a14ed7da0b9e63e95d8cad04bd1ff03dbe0,0x85754697881064255cf819a2807419dd4762a8ff1d9bca26c43f2abd0aefd1a66891e4ba556c4b979f5855b03a525758
399,679,123256,210126794,0,0,32213909727,32003782933,0x74ee278b0a8debf7efbf2e3a0710d007f3b24de7,0xaae8613fc00093816d1b2aa0cc471b8cb9865fbe716cd247ff32824b9ab30133185ed550e6ab23ac8eed21b47fccc3e2
,680,123816,210121123,2,0,32212443086,32002321963,0x8a5a986d11dfd812c88b8f131bbafe306b478969,0xa560bd2a38f06a43edad7d006a825360d8b97f4273c503a9575c2b46a46fac2f6300be92e3abd036ba6cef9cddd194f7
400,681,123284,210057997,0,0,32213699842,32003641845,0x3ed33cce88d9a6b4ce4cfe3fc84e2f1e41562642,0x80d562bd5681ead11a81b2ffbfb21f52c717be8f24e41d1ac44f601fce8796337ba952ea0845a3df4b53a98c0cf49237
401,682,123683,210057497,0,0,32212009924,32001952427,0xc23f6eb8d5b23734b2b35277c71c9b50ae8a7400,0xb354fa32685e25993c60a6be3f7d6bb7f888902e5b5fa29c0d66bd23a81f6a496a46edda8d61d2d90221dcb3a964c483
402,683,123649,210005413,0,0,32212173776,32002168363,0xf0f150ef0068659702f38ef5939c070b7c8dc072,0xb10c6c8e853b024c77a041c957907602b04e230a6ea5ed0f43f1ec52a55da397491b4d0767804ef2b37ae3978e3a4372
403,684,123543,209961579,5,0,32215184068,32005222489,0xb38db4853325b92b3f21e553f327169a91fd64e0,0xae35795c316fdc5c9571ecbb46e7d0669dc6bd379dd3bcac635b90b5345f5aae9e7e5083bbdaf380e7a506681d1615a9
404,685,123262,209943865,0,0,32213807202,32003863337,0x89c4523f0af9f334d9e3df103a270df6367ef012,0xa2189a89ddf765537fb7ac9361ab028718a1cdec236c9a695c1c5d6ca0b80222bcb1d848a36e41551c70a31fefd461c3
405,686,123271,209849776,0,0,32213625950,32003776174,0x79f7d4d70ac346760713238878321ea32488f141,0x83c6bafba0abed03c8d41e7d458b1032da234be4dc56f3948e0de6f5cd94c5ec78f3f42300b9f4bb45b468f021f3d74f
406,687,123672,209798926,0,0,32211785155,32001986229,0x157da77f4e2e801778c4fc31dfb04390b03f28c8,0xab3829e9355267a806fc302b304307ae0be97afe32e2dff516c17d66109d2cd1ccecb8165ee3306052cd2f45bcfbd8c0
407,688,123646,209729097,0,0,32211840045,32002110948,0xf07a38be2eb43ea6416252a43e1b7bac91196fb7,0x8bf10729e8b580a705de26fb28d71f00a519e8613e90fd81c43abc877f36b3fdde36d82ae7bc3fd13afdf112e09742c3
408,689,123930,209715620,1,0,32211263895,32001548275,0xe8ada2c8d43bcb9020ae605b3d68a645ce5c9632,0x94811c271db8eb43e356c63b10f8defb8e66edcc71370da4cb442aabb40efcfaa8dca246c385d18842a5fcbd14d25d50
409,690,123260,209696926,0,0,32213495312,32003798386,0x068005725f72cbffe937bd652cb037d70f83a148,0x881738f15b4911dd67223e1df01746e1fb447e6c9c86096d31eac6f3fcccb2d9ec3a2f064e0d11535b2a642b7682459c
,691,105611,209690038,2,0,64386779949,64177089911,0x2aaeac592750cd4b39e118f0f1dccf3389c4a0e8,0x965d0ddd33fa3e9aa2c97cee4357c34553fb8f829074bc33ca5d787661ef65410525b92b2a5a6ba57a6a6714646a6bf0
410,692,123671,209656836,0,0,32211611118,32001954282,0xe143c9bb4551415dafa77579745923a9df0ed497,0x99613c7a5c4a183a3513c078f2d2c47761923dc73d67a143626af5037e1b5598e9c178851b3a84423aaebe09bb374f33
,693,123316,209647389,0,0,32216027130,32006379741,0x24bde324b104db032f42905562896ee51de366d4,0x89bc288480d73ae8017e336eff7f7c211ecbfbcf4dcd2370981a121e3bac594620cf9628b8ad6b535f344f59c8cde813
411,694,124341,209630986,5,940,32209630986,32000000000,0x13f31232a569867b037d51c3ff11190fa6e240f4,0xb9f90bab777578c2a71b842744b32f10a2259e7f0957fd636ed2c097abe03be37e5265bf643b387cf5ce8c3fc09ec485
,695,123842,209610047,1,0,32211752721,32002142674,0xf69c1c534779305edbb5c101d76c8d41c1eb7d9b,0x8dd7658bfa3eb3f9f120f9defa6f5534d743d1f67909290a4f68a129628fafea4933cbf02dc931b47f41a8c3b869e21c
,696,124133,209583299,2,356,32209583299,32000000000,0x4977294a902e2263a6d7c58a839f5cb1160ea259,0xb94872a61a5b1adb8e7628865901bfd036423a457f8bbd9aa3e36ab8ef0135bec5e3ec5042ad86243211048085c2e625
,697,106471,209582401,1,0,64388156822,64178574421,0x8406207761db4cd6773a5946436537b798b61979,0x8ecda2f2b7b68d8976903acd4c43e5a03ee50dc0fd1514a0130796913a6581af3387568c4e27c27cd898f3a888b2e843
412,698,107064,209577499,1,0,64377580151,64168002652,0x106f5e301486d2c409ac2a0bcdb4eadb27d228ba,0x8b0f22cb6ba92e68ff11cb5c9b89273ffaf4510b45ff08b871e9b36a685e074f0c8bf0b49e3e44147a00b5ed4cf8b689
,699,106462,209552740,2,0,64378863578,64169310838,0xb45565c05ff0c123c738aa6f6fe6db5cba787334,0xa1466f128ade6423ab344e05d354502743a8abb62689e5b945da887290facc5b3461565b7e70288bb57b96164825b49e
,700,123880,209500348,2,0,32211465867,32001965519,0xb4c6b0bbb950be7d08fe577915c9d40df43557be,0xaec944177ea00195fb8e52101be2e4a0321d2f6ae69466ca9612a1e45805f8e8ccb2d5212f393cfc60f8ad4bd541e44a
,701,124203,209482041,4,555,32209482041,32000000000,0x481cde8a1a9de191821edd0a60e8ef38a433562c,0xa7f2cbcdec445e2fd983bc60f2e4caea317ccb80f71550f0344193599b88d9086247f609977d10ffd1827ecb2432f56c
413,702,123258,209471352,0,0,32213288880,32003817528,0x87be6eccdae001060707e9da229d14f858c5dee3,0x98747d11ea81ccb9e4ab39ffb16ebf9e419820ec7c25fb72e1ba2411f483870fbb392705273b1a061fb230b317193be8
,703,124222,209383493,7,622,32209383493,32000000000,0x0c02d5c64f40fcfe10bf65ee900598b6bf9f8ded,0xa030780bb22a6f2137793e2f1a70f0e946b31fb5dbe4597cf706869492be15b8b6ecda978d6b1ad22b453368d04139bf
,704,124107,209338981,1,291,32209338981,32000000000,0xf2667438a7bcec847ac58c4ca6fcfc68c152cad0,0xad6af8fdb325d60d91edcb9ae1ac984301e8b6cd6b0b7fc265d788c6474029cc9ff5bb406b72e4488dbec2b91aa8e468
414,705,123257,209327830,0,0,32213181731,32003853901,0x10cdd04506db3258110b0f72ca942d698239ef38,0x8baba385c2de055d8148198913ad3ca62365b5414ba7c7eca7d5d7bd350363618701dd0ba69985f3bc3a409a5b0314d3
,706,123838,209253486,1,0,32211493320,32002239834,0x15e96a14ed7da0b9e63e95d8cad04bd1ff03dbe0,0x85dcd33c9a124634c247bda9e1fa9c2423c29ec5fe16842af9b95d7ef773b143e81bd37cd6cb1655e1358e8a50629d7d
415,707,123492,209137022,2,0,32208754810,31999617788,0x03119203679795299e202508e569d1110a2b74fd,0x94c7e44598b7f059cf9d9105f5decc90ad6b1cf5944df3114a5a5bc19bea843949e2cab0da27f50e49a779028b4bf192
,708,123367,209103060,0,0,32207737720,31998634660,0xb911dda495abb49c4e221ba6dd432ed8918dd242,0x822c67d729a75cb1e7eacb31b2160fefa9c90023d8d0967303bbee8416da064c1d94593b49f52997a4ddfd65c39e0bc2
,709,123513,209066133,6,0,32203901198,31994835065,0xc7ffc28142ec9cb93d1492ed2b8057d0f2b12fee,0x938a980e19d6c30756b0903f4cd427507730cd1729e03cf8a53ec471a209b8a561e43e654c6a9bc56c9e72b1fb6f2d9b
,710,124235,208754888,5,625,32208754888,32000000000,0x4ade5515303d36758b41540334410301f9e4b4b6,0x93ec05b5b462ae6aab27fff3b2b31cc3544eb1515b98b0346acee4c2303ef047ad1b1c8bbd181f3efda907b909b6d93d
,711,124109,208353682,1,292,32208353682,32000000000,0xf2667438a7bcec847ac58c4ca6fcfc68c152cad0,0xb046b9de46955d7a7a1fd493d78a4231ec0289847d6fa6a2e58c0857ee08f2bf1313b9d3b4f9dc56e277b66fa0d6b175
416,712,123569,208137116,2,0,32213320797,32005183681,0x0a76402405b1a37f1916131ef035e2f5297674b8,0x971dd4442483e7eceefbf9255c41ef9e8d73a52856d8053f7ad4a4a3a3bd0f0053f4895f20c6eca5aba870adfbd27363
,713,124098,207642659,0,228,32207642659,32000000000,0x832b9c76d81ab1f6bb8f967f394d39fdb5c12a58,0xab7a3660e63f6cd6f2e03788fa87b85b535711e49d778d4576f06d199c487bfbb4d4f43b4d7f97dc529655fcba9df1fe
,714,123370,207453084,6,0,32213679181,32006226097,0x4043c76cd517b0de74d58fe782d67a56501162da,0xa349a057ce92bba2d765d7aa2abb8a089b321df65383b091c5c3269c7fc95ee5b5b11d0de81b21708b92c0de73c4a60d
,715,124166,207427932,7,424,32207427932,32000000000,0x75c8c9e5c64e9830814446d3b20b71ce3d19a21e,0xa8db1c9844b5b74974ae2179ca78a1da50c279a8a9b8aa1d0b83511448b1866acf30adbfb16925f8cefa579ab39ce72c
,716,123426,207279687,3,0,32212925583,32005645896,0xcb64923781ee85e71b85ae5953f30abcc22b87cc,0xa3887adb7864eb93557a2d4d9ab1687213920ef2c1271a7adabf6d914ab5ada5a88ee28ab80bb8dd8804dc107e8a7176
417,717,123951,207227851,6,0,32205900585,31998672734,0x4480d7e1315cafaff96dbc0e0cbc09050adaa4c9,0xb092e9bee85e4790be62d3b8aeb7eafd09c23d98d815c779fe8be8be00094dbff24043b1be15840df0694057bb40c48a
418,718,123385,207129324,1,0,32213266176,32006136852,0xb237adb898de896b263c334bbee8eee7df414598,0xb146ba73e29661e15bb4c3545029a77cc236dbc9e4837b9dff731d340a27da5bb9ade6d79845aade73d7cf4b0724a5a5
,719,123960,207106538,2,0,32208329227,32001222689,0x75c8c9e5c64e9830814446d3b20b71ce3d19a21e,0x86e54d9089ceb250b94a1fe0cdb6144a8afaf32116baf5aee19d9e8e8149742150bb26c0c8f0d4b005a2425e9ee0f117
,720,123310,207078669,0,0,32213515950,32006437281,0x68498b5bca2049133141e4e9583114b8f0b0189b,0xb33d9fb4ecb040ccc87a95a60ecbeab26092b28593edf5ad82149129990a7dfa23c9254ec5737169ae0e7b0f84e08697
,721,124040,207012690,1,51,32207012690,32000000000,0x8fc668c95c1980e8d1a91734382e0b39204adaf5,0xb215cfa318ffdb7243fc23972cee8d79efd4547efe25f1acea5fd7e5823c71ff85f2164772023937a922ee741b00c4f4
,722,124152,206957324,1,421,32206957324,32000000000,0xdb12f73f7301c1efd1c8f468a187901507bd72ca,0x8ad03283a8ef957ba4d57df4a4d64c6e79c3c32af7d8213d58b0715ffea26863ce35ea2624438c221038b1b6d5e4da8a
419,723,123839,206911936,0,0,32209044527,32002132591,0x4d824d9604b183dbd161aa33e23a225108395c8a,0x970255f203e7be104f37e1f3d7e5b7c5672f7466a79f8d5e7166b2761cb9107051ea56409d3efb070e855ecff2a615e6
,724,106483,206895158,0,0,64378531356,64171636198,0xc9edc1d5e8e2ddfc7f453c65226ad971545b8d49,0x81bede4f8b88249270fc09e8c136be10e16f46182c0652733a9dd391f2b2d88ee53cfef8ee44b43891bf225b65320fdd
420,725,124179,206866045,3,549,32206866045,32000000000,0xc1b2cdabab813154037874786842a7107ef17876,0x958e5db15edbdbc70c44f332190bde388324d661f6528089e02a092353ca3cd4f74c762acbdda35e1dece0d2276a101b
,726,123309,206817762,0,0,32213225314,32006407552,0x68498b5bca2049133141e4e9583114b8f0b0189b,0x837da14f029b4f58e90411b94f7d6f450468725fd3fb0f4f6e37012b3bc444753f2a7b7c44edb95d442031d742ab61b6
,727,121590,206804556,0,0,32236315324,32029510768,0x68498b5bca2049133141e4e9583114b8f0b0189b,0xb48adc424b372a8e18f109a5f49c406d380b1752301d6e703a177e11c1360c9eaeb55b09d3c5e80c1e0c39aeb18c03a7
,728,123958,206723333,3,0,32208004027,32001280694,0x75c8c9e5c64e9830814446d3b20b71ce3d19a21e,0x91e6b32d47166c99fe1f14c8921aa83f9c475dd5101d4c0d65855859b5a0bcbec779661755e437ff18de671610e95d8c
,729,124141,206682854,1,358,32206682854,32000000000,0xd926a891a3db92ba6f097074ce1ad4b3cde2a3a5,0x987d8fde2aeabfe550030d8f1018907c815a4c1349e785eea0c0621df9deebbc89d1e218b2ddc119c28e560cbe1776e3
421,730,124277,206618620,2,808,32206618620,32000000000,0x12a96e741000fed30d95c00f3d00255b9c5ae195,0x8f2494930f76ae2364c090cda3bc2f8622492975e98b61a75b872d44b328fc9963ab4ee9f47606759692d170aa5b830c
,731,107065,206616635,0,0,64395066451,64188449816,0x106f5e301486d2c409ac2a0bcdb4eadb27d228ba,0xb434d7430f701715c7737bce4bf22f6d2554882f1016581092994668043f2e8e18aa18f55ecfcb5129eb8fe51af2db96
,732,123931,206587762,0,0,32208188409,32001600647,0xe8ada2c8d43bcb9020ae605b3d68a645ce5c9632,0xada04d241202b71db03e8ba23c8373f9450177c2ae7dec89be39789f5bc5ce84650bf7bf4d7335ce3600d9427877180b
,733,105435,206551168,0,0,64414131721,64207580553,0xc640a1159fca4d23f56b746c3ba1532e6f0276b8,0x9653d7f6d498e17b589250888870b2029a227fd18a77ca3a4abc613273828fa452bc39b7838ffc669e6ab4725bbf34ab
422,734,124027,206549320,1,48,32206549320,32000000000,0xfd804e940951f1a204b1c41d3cff450bbbef69c6,0x8d5c2dc776636389be224650d54ee64088975e095dca83b89bc27a6f907deb126f162364f17510f3f3799b82174a7d36
423,735,123846,206548254,0,0,32208637601,32002089347,0xe26a1f2e7ca49504aee97e00de65dec8a5ae75fb,0x802e53dd54a424bb4373ad78d19b3fe934bf42bc8933a10341f369f23f696c8f91c3cdb627ee8e5689a8c5d327a5a995
,736,123438,206512343,0,0,32212234427,32005722084,0xed9422da0c15782360803b8868b0777ececab111,0x96942e241dedf474224dac7af27b9b96edcefc01d19a95c78473e67464f0ba9b41dc9fc680de9b9f9af6020a34dff71b
,737,123521,206492794,5,0,32211697094,32005204300,0x75c8c9e5c64e9830814446d3b20b71ce3d19a21e,0xab7873eafd3fe990d0fd4908c4c1675ba71ca4d92afc577df08f0b3836b05a8429b0fef81f4d87902f6711f90052aa30
,738,106470,206490652,0,0,64412044871,64205554219,0xd28a4e1cd5d23ee10da8b7b0f9c812694dde50ef,0x8b9835363c227808ba5540bf44f1991f2c36861a9bf0d1b0e37fb6bdc633f060f2adefa94ad4deb0f00cc1c008751e24
,739,107055,206453212,0,0,64382003132,64175549920,0x205cc7641fbedae5224e7961c6698fc10329fd42,0xb2661f47d5706dd1d0a7592635124c01c797db30092d669c0a645115338efe94d0f6c9329effe3f9aca71545e6ca2ed1
,740,124131,206450668,2,356,32206450668,32000000000,0xff6657fb62d096e48df19d3fac645b3f250b73ba,0xaff58921fe90b4a3880c8471fe3ec6382841afc7c61802b818cae8ae487600e6237c26a4fda22a02cca0b4f89c9f984f
,741,123847,206376296,0,0,32208447516,32002071220,0xe26a1f2e7ca49504aee97e00de65dec8a5ae75fb,0xa5e5f8d0b56bd817328dff5c88153c814b5aa2da998b12420e655bc8c8bd8088e9f1142dfcf97238aeb586efcc7d6796
,742,123733,206339412,2,0,32210430813,32004091401,0x75c8c9e5c64e9830814446d3b20b71ce3d19a21e,0xa3f4faf0b864ecf296e8f80e99c62058304df6546c7627b88ed9e9c80e09b83e6a0bb475cec83f80be364c149c57ed45
,743,105620,206239403,0,0,64486047175,64279807772,0x1ef0ae72a8a1be143055416a1f41112e0d60ebbc,0x8edcd6b53c3f4f77995b28fd410c568ff162dc8403a60d16c65ef0eccc81cd6e785ff5eee85382ef63728649fdb7d0e1
,744,124193,206237826,2,552,32206237826,32000000000,0x2677761b0edf2019029f580431a5f0d76dab5058,0x98993f4deb1da4ac5adb44fce5d15ce5204824485ed8d2ff3943b2e70e4ec86f5bfbc140925962b3d349b3fe02df9085
,745,123427,206112598,3,0,32211873462,32005760864,0xcb64923781ee85e71b85ae5953f30abcc22b87cc,0xad573e5b4319fb2915957075b9118d6173daccf08b93bab0a14584124db24a94bbedde5f3f117210ba1f9c1ec82dfdd1
,746,105597,206038614,0,0,64415874792,64209836178,0xcbf2c50f7e75a5d6061e48d9b8d7b501ff7e9d2c,0xae815fc04f67d985d85642ddd3a7214f0cc07b365cc9f7c73d6c5e67d72ceefe6c91047d468d3d0f84d6d9145267f5d9
,747,124076,205982489,4,172,32205982489,32000000000,0x75c8c9e5c64e9830814446d3b20b71ce3d19a21e,0x900448129a7301ddf810b3af55b2b209d2f9482d11007de118ff6ae1ca301f42585dd5e6042df8617258e0896cd61f8b
,748,123841,205948674,0,0,32208155496,32002206822,0x4d824d9604b183dbd161aa33e23a225108395c8a,0x8fe2a44ee731fca9d3d9ed77bfefa48dfb740a9475b8aa1730d5ba832c0fe5fc2b35b968ddb7ac5b7e6068d18d7a2f03
424,749,123468,205934002,4,0,32207357856,32001423854,0x4e0ac1ba9c98f88590bbe4749f5e26fecb7141c3,0x8bb6d4e14029d055c8c2a399e5db5039b54b0ebdb1523a1bf35add10e76454e3dc9f00421b9fc457adc3b1335b7c011f
,750,124079,205918173,3,173,32205918173,32000000000,0x75c8c9e5c64e9830814446d3b20b71ce3d19a21e,0x8b7d7ceb9d46a967c6107ce36780dbc7b726a95d197fb6db039f39335b4dcdbbec26b4147210749a0adc58adab65e85c
,751,124075,205795937,7,172,32205795937,32000000000,0x75c8c9e5c64e9830814446d3b20b71ce3d19a21e,0x8bae9c814f4a271b267941ef8f11e36a9310a671fc310b5f600d87342d3c2e9a30c1f6d5d7cf9e998533ba920a627d83
,752,124130,205628117,2,355,32205628117,32000000000,0xd926a891a3db92ba6f097074ce1ad4b3cde2a3a5,0x882775f32a7b0457a0bda406df938074d5898d0a0eaf0d990e4bae638bd74d802313aa3a1c45daef3158aab145980d94
,753,124187,205521841,2,551,32205521841,32000000000,0xa840c9b73f809c9b603a3bc58d927e6577d5e06b,0xb292a0f90926fea1bfd25e47a4ef8fa1745c0fa010f07bf2dd6f288d5f9d76e96a05aff8af05efc4633ac6fc8b0d8bbf
,754,124194,205414170,3,553,32205414170,32000000000,0x2677761b0edf2019029f580431a5f0d76dab5058,0x96dfb244288073537daaf411eab19715aac5b5b20de7062921f3606069da8f7079d2bc7335adbc3a2e0d507de1613da6
,755,124083,205218774,3,174,32205218774,32000000000,0x75c8c9e5c64e9830814446d3b20b71ce3d19a21e,0x8ad4e2423f3c4baaf3e479b0063ce51dc7d941e99122be066c96bcf3c80d6d42cd9d38dcf7f00a876c680107b8fe4998
,756,123412,205102674,2,0,32210931334,32005828660,0xcb64923781ee85e71b85ae5953f30abcc22b87cc,0xac67a1a06f1af93b25716f9973d13efd49530d900e5ac8b504abff400e34074eef0070ae5e104e46e99b690ad76802ac
425,757,124322,204769630,6,935,32204769630,32000000000,0x9076fc7472973203f73e1aa182b6cdeba8ed314c,0xb2f3e2c01b0161ac9619f256e14745bea4d420c97d80be2acee82501d7c3ec1307d4aaf55bc84fabcc310cb160c6dc69
426,758,124016,204545162,2,45,32204545162,32000000000,0x1d83be013b01c8ad9ff8afd497a5b27e8f310b45,0x8a7184c108a49479c0c92e250ee291f2c8c1c3930dab393f8374ad25c3e4b916554152dc9d2b9e56f3786a7ea6cdf3cf
,759,123414,204466988,2,0,32210269433,32005802445,0xcb64923781ee85e71b85ae5953f30abcc22b87cc,0xa8492b5fb245cac32c7851585600be756c1c62bac1f4e7f4a9429030a77c701678a305e6b72c7a6c6b0bbfd01fa46231
,760,123334,204463680,2,0,32210838682,32006375002,0xb38db4853325b92b3f21e553f327169a91fd64e0,0xacf1571732c0bc99777d3fb247f6f77397faf4bc94cdef84b5acc7b6660a9e952c8b6d9e59404f743724c9e1566adf7a
,761,123396,204273664,0,0,32210388937,32006115273,0xb237adb898de896b263c334bbee8eee7df414598,0xa924a0d839ec45e94fff38d22b60af7f5611f96e7972076335f5a7924a5621e425f7ea279b222b603b3afcc51cfcc2eb
,762,124279,204264540,5,808,32204264540,32000000000,0x12a96e741000fed30d95c00f3d00255b9c5ae195,0x838276f99b8d36de50bfb5ee9d579ef550e9fa09c263bce61910f02545ec916de285d1d5eecf5fdee63c900a783f041a
,763,123408,204249546,1,0,32209876039,32005626493,0xcb64923781ee85e71b85ae5953f30abcc22b87cc,0x9097057b3ffba291be0c40a89b3b3d9fd3fbc7685f845d1ba0bd9f7a4712efdadfd82823018dabbd39f3fec85e68c84c
,764,124295,204121688,7,812,32204121688,32000000000,0x4cfde44716fbd4a357f3b3ac4be756aae52920a2,0xaea9a3926d3139269159d21e552cb578579461c8d3e8c7fdc3062fea84b25bae7f3e520ff9c748b7577559c8c84eedfd
427,765,124116,204118046,0,293,32204118046,32000000000,0x4b73324ceafb7f33f2500ccbe62f79730f171986,0xb8017d7dbe84cf2a9c4d61c7dbf162e55f37b1c1b4470534a5934cb3c2f67d4f45372350e2c9b539b03d5e981abda452
428,766,124049,204055427,1,165,32204055427,32000000000,0x7f362b0f7207bb6c133f0b86c2e9f004a892f91c,0x8b80f8da13602dcb7e34b613c73082ea69225874392c3f399232d8242cbd85b4fcb442cb7d3b03591cdba0c2bfac508a
,767,123423,203928815,1,0,32209513355,32005584540,0xcb64923781ee85e71b85ae5953f30abcc22b87cc,0xa1698d89a84ef6ba4d4f7b884eb84c9eef7defd902002012481ba212bcf60c921ad1dad1af7ed4ebd22e380bb3bbfd82
,768,123422,203802224,2,0,32209389545,32005587321,0xcb64923781ee85e71b85ae5953f30abcc22b87cc,0x9778fc7f5b66ebf61c6c7fd0522bc2494823a37c332f3e28947f00bd2f44798316f2f55a4ba1d226b0449c78a5e33905
429,769,124007,203589971,5,43,32203589971,32000000000,0xb38e943206b23a2e0456b88b0030885457f8a898,0xb80e9d781c7b25b41b11ecd32a859e8318dc0cc76f32a3df9f35c303baaa11de4dd130a3fc4cb26b35ca5d1baca6b644
,770,123420,203500568,2,0,32209123987,32005623419,0xcb64923781ee85e71b85ae5953f30abcc22b87cc,0x8938adad20923adc8032cc4416e1991da28fc24f215c963bb12ca42d3dac185fcfd86e6da588fda581993db59b821d4a
430,771,124325,203283676,6,936,32203283676,32000000000,0xa0099c2f56e2843fb220e1b66632eab4b8984efa,0xa19e1dc1aa28893e50eba309e69a1d1f7cf277324c5c555666e0c03487f272b9c8a70c81cb46ff5dabb2007dc466b4c4
,772,123466,203203093,2,0,32201459484,31998256391,0x4e0ac1ba9c98f88590bbe4749f5e26fecb7141c3,0xa1e3fd70603ca8418e3351a2f6fae4b1281633fcff5c0a38d1840891ed65d6c539bea758ff0135230036b6c6e05bece7
,773,123428,202857994,2,0,32208481762,32005623768,0xcb64923781ee85e71b85ae5953f30abcc22b87cc,0xa22d5cb99b57992f50c96a45388c487bb9bc8ef41684c6539122106e9093af12f098e68d5c4ef8bad05b2aedb4a22e1d
431,774,124065,202574345,4,169,32202574345,32000000000,0x134962ed865d354079c4c90a3dfad97c79745913,0x924dce8db92d08157ee9586a7aeb048c589de48da3b3f0253e35a759cd5dfce45747d1eb63b09af05504d45bd14b8719
432,775,124183,202320379,3,550,32202320379,32000000000,0x18ec46f85e088439d2a2a1f4de546cee4c562d45,0xa6a729eb7bd6caec8fae5747b4a4b27ac1cf0dec7874e379a2c5152d95bc97bda69c59f8a97062908fe4e59270feb20e
,776,124080,202222000,5,173,32202222000,32000000000,0x75c8c9e5c64e9830814446d3b20b71ce3d19a21e,0x87a8b9461814267148f9b275ec0f4ce4de14e0831213807f97c8f43940fe6ef118d5ee0eabe9c4710e83f67f93bbba85
,777,124165,201911843,6,424,32201911843,32000000000,0x75c8c9e5c64e9830814446d3b20b71ce3d19a21e,0xb332ad275a1c6bfa6f4690c38e21df4ff4a07589dd4415ccdd95a7eaf47461660416570cc316803c4c28dddf5c14586a
,778,123418,201834172,0,0,32207633043,32005798871,0xcb64923781ee85e71b85ae5953f30abcc22b87cc,0xa1e014e31af06af32f70dfff9b9ac53edadae3730d16839cbbb2b0babe74eed8b711f15b8beec11e86274fbe5f32a23d
433,779,124308,201777914,5,816,32201777914,32000000000,0x8b4b6f437fd0e44551ad1acb15a7d0f64cf8fad1,0x8c7bfcfc1bdc38aeddfb1653ac2f624ff5cdfd2dbedb998b414dad435a4f34511c137752b93bfed6a6b8d2b932a9de6d
434,780,123956,201712931,3,0,32202704349,32000991418,0xf2c5eef73432b7c203036ae3c78b52d1c0073c69,0x9116263241e604a2409c78e69c854417e4f6ae63a02135d7e914d2a8d36ca7d8fd39b6700c9066f26acc49b4696010af
435,781,124208,201623194,1,556,32201623194,32000000000,0x56b96de8d2e1dce7d891de3e0ccbb543f5290631,0x9031989ee9029d31a51752b5c05840e5a891e6a3300a348bdba82654164474f9796ed1ab38288324284269041e3ea58f
,782,124142,201591586,3,358,32201591586,32000000000,0x8fc668c95c1980e8d1a91734382e0b39204adaf5,0xb0b50eb443f4d289f096e1149795008ef973c8d7a9e1d4a27d742518265dd29dab82f3891da4c793213e2526ba018d9a
,783,124283,201472422,3,809,32201472422,32000000000,0x4006cb341763c02b716b65dee5eeb79728304bbb,0xadaa18362cea5136c130ddd1181850055607e10364a3f75fa6150f876fe8da6638da2095a479dbf5edae834cfd18f03b
,784,124019,201432408,0,46,32201432408,32000000000,0x1d83be013b01c8ad9ff8afd497a5b27e8f310b45,0x8e79d0ff046118d378b4cf574a2718a13c69c03a1365bd55fd1f14c1ce17c95b990afde43a954a1d5a38b0129fc4fbaf
,785,124313,201257898,5,817,32201257898,32000000000,0x4480d7e1315cafaff96dbc0e0cbc09050adaa4c9,0xa15a52b9ab413094b0d2c1b4d1c9f46a51e586f7ccb91c7c412856d8a2249af1acce8f5f7ccf9038b3b6f76446974114
,786,123074,201085681,2,0,32208693836,32007608155,0x75c8c9e5c64e9830814446d3b20b71ce3d19a21e,0xa60bf794e6418d27d34cc0da4de18880bc32ea6fb3d9c3036e16b7a56489794c507cc24959380a9b41e76f189e4ce85a
436,787,124350,200951594,5,942,32200951594,32000000000,0x44e4aa8ee55e9308b67bb8b0adb0364ed1439071,0xa7e1146741b0d1334147914c2e67d1ed16afb3ae466446ff200d6ecd0fa9dfc2040ae2cb6f245f83073fe0ef51ba2a92
,788,124343,200846140,6,941,32200846140,32000000000,0x13f31232a569867b037d51c3ff11190fa6e240f4,0x8a23f544f7c56a15be9f7fe681ae33db4d2820a73cb8e534e9ae5684cca9f1a64996accbbe0cc48002aeee508282a53d
,789,123409,200781293,0,0,32206527658,32005746365,0xcb64923781ee85e71b85ae5953f30abcc22b87cc,0x84ea0812b5a3add59c653435fbf317cfa9e4e448af82b340cb7f345a3bf1c18ffe74c3ec1c5cd0f8b78c36828e2ea8ff
437,790,124359,200709783,5,945,32200709783,32000000000,0x3e12201a639762a249ec88bbc54a279f37e5698b,0xa878ad3348d61293ea942b5c25997841da884555da56b79e269eac0be7477ff54f09464c0d786777a496b1cd34896318
,791,123425,200639921,0,0,32212503942,32011864021,0xcb64923781ee85e71b85ae5953f30abcc22b87cc,0x80372a023d084442b7fea8c291fdbb330e132c80ca5e4e121636e7209711bd4abfa1e87c2b9938847453001ddf53787b
,792,124009,200596328,2,44,32200596328,32000000000,0xb38e943206b23a2e0456b88b0030885457f8a898,0xad3278df94fa7c75a79ddeb2b0f8437e3bb200d9433a6da285d87efd0efb9fb1357b2807fea28ea30414512cb80b6d48
,793,123732,200524079,2,0,32207771093,32007247014,0x75c8c9e5c64e9830814446d3b20b71ce3d19a21e,0x91d55f0c93342626dc6c0862796c466ffeec663576752cd9478e1f37ea1e3e77d5f981549481b05a188063cb637e7b06
,794,124180,200469293,2,549,32200469293,32000000000,0xc1b2cdabab813154037874786842a7107ef17876,0x888bd1f622c9c70157121c2ad7a1cecb8389548341ee8780b4532a0c568319d5c6b5f2b7799ec440175408377d015093
438,795,123940,199963031,1,0,32201498411,32001535380,0x0c1b2725c75156fd3ecb491ef801668efee1344a,0xb4b4bfe3e5ee5ea9e9cfcf7e8a2ca5772686216f692cde0803a58906465df639e11efa636791399bee0c394d8137168d
,796,124342,199921159,6,940,32199921159,32000000000,0x13f31232a569867b037d51c3ff11190fa6e240f4,0xaf1ca0ae72744e8dac01c50c3997481888c7f9bb4ed5d3d182db64ecf5ed95ae3f47ee6a1148bd38b316dffbd7ceb231
,797,124168,199758417,4,425,32199758417,32000000000,0x75c8c9e5c64e9830814446d3b20b71ce3d19a21e,0x85f5812123f13a1999879591df4afd22597ece0b178c74268d42c22bb865f3b1782679c6118c8ebc23c61cb6ea8ad5d2
,798,124174,199710081,0,548,32199710081,32000000000,0x2677761b0edf2019029f580431a5f0d76dab5058,0xa8e29561990b96910c1b83d7f78b825ded26723d3d424a8c42deadbcaf6b161dae26ba0faa8db69b7e741678968bef31
,799,124175,199586382,0,548,32199586382,32000000000,0x2677761b0edf2019029f580431a5f0d76dab5058,0xa32ef5dae89325bf5b77d94a46bef7b9735ca2d3b9111a5e2245647eee6830ca7795bc8d15bf14fb449dd0b51845d521
,800,124376,199494477,5,1009,32199494477,32000000000,0x521deb0d352d70868a6c3952b3bd478f11eeffcb,0xa90d5cff14dd4342110f08aa40c21741b9d3b55c62393a0b312344f9b77da00ae40cd056110b719b6d3cd7344934f38c
439,801,123225,198966097,1,0,32205804796,32006838699,0x8d8b9d2e5577ad98d7e57ce866418756151b6301,0x835f923112a6aa183d5a5a2f1919a2523193edf14d9cc284fe551bc111ef800b5fd90f8f86b0a13d48a22dfe0a230222
,802,124188,198836572,0,551,32198836572,32000000000,0xa840c9b73f809c9b603a3bc58d927e6577d5e06b,0x87445813739d381ca482d5a6f2b03af4d622711a75b438e9b9c302bbd1d5a06443035f7df74fbd3936593eb5872d2d82
,803,124309,198714828,3,816,32198714828,32000000000,0x8b4b6f437fd0e44551ad1acb15a7d0f64cf8fad1,0x912c40f6895e04a898d5df14cdfcf6bc29fb9abeafef44037c772e658663519ea2244c4ef6fc9b8cc51dc3547d6df429
440,804,123537,198215504,1,0,32203395998,32005180494,0x5c7666b1a842774318ac43087dfe0ef7eaadc06c,0x85d7814e05cafab935f08e7c6949d03325b07d2538e7230d1a51e505b24b508b8497e9245d3427f0b25ea01290291f06
,805,124045,198125084,0,164,32198125084,32000000000,0x8fc668c95c1980e8d1a91734382e0b39204adaf5,0xa36dc302379acc06ffff05e72eac713ad2581ee1342e96fc35d454aa48b906533fab84ee9f98a517381d7b3a08e0e6c3
,806,124296,197945601,3,813,32197945601,32000000000,0x17e25693b3acb0539bf8ac6a405b22b24aa21b50,0xb91af6c90ef2e88acde79d7920de616dd82482ac5bd53ef645a9457dc852b282832fd4727cd70f6e0a7001c73d4f8a71
,807,124349,197817751,5,942,32197817751,32000000000,0x44e4aa8ee55e9308b67bb8b0adb0364ed1439071,0xa34897eaadcf754a67d35b573589ee8a5e9fc9544202cb0e20cc960ae6aef63beaebfed1eb6532ed924aa9881f5935e0
,808,123963,197743276,0,0,32198955407,32001212131,0x75c8c9e5c64e9830814446d3b20b71ce3d19a21e,0x884a15010bd3913f114e39a0ad3770ebf36873174174ce5f1302aead6f6156929e1bebf1e546ddedc707af0036d9c238
,809,124282,197717883,1,809,32197717883,32000000000,0x4006cb341763c02b716b65dee5eeb79728304bbb,0x92edcb2a8f3ff7b2717b0334c2ddef549e4fcbc7ac25efe2c58f0ce9442f8eb3db93037f4743619eddf5f4aa1d82d6af
441,810,124391,197526397,6,1071,32197526397,32000000000,0x29a7aff9998170f96208a48d6c3e99cb8e9f5e81,0x8313a7f525a7b33721ca75d4c5bacb7eab265699caae7f67a0ee3d6974ca0b6d8b0eede563d8b11b2540823dfc785b7a
442,811,124252,197490444,2,683,32197490444,32000000000,0xc1be55c58493ce53b754e876c2c32916e4ef3533,0x9844cf5720f7e5822118aaf5524b9094b9095154d813c6a29eef1b86dacf91c94bed92f7f19efcb8d9adcdb767f0855a
,812,124077,197193039,2,172,32197193039,32000000000,0x75c8c9e5c64e9830814446d3b20b71ce3d19a21e,0x89078a37a0afbdf72e46ee1fe2bb36062e22bb7aeda15c56308dfebb18d6771010d0ed5b134e8767be6345451eece3a9
,813,124177,197034571,4,548,32197034571,32000000000,0x8d6b61de69358cca25fef4b7f583bf3ca95a373f,0x974fbe55b018f4110c8af7018439c2b595131f0cc9df6c4a82aa5ef3187a10a60559a2ecd4abe88144e2e1512c6609d4
,814,124085,196963797,1,174,32196963797,32000000000,0x75c8c9e5c64e9830814446d3b20b71ce3d19a21e,0x91f59e1aa5ad28fd2c8961f4a19ca3413e1b107393d5bb3ea69982cd742b74b3f266b4c967dc4629b7cb8b18bba5882f
,815,123250,196919211,0,0,32206233411,32009314200,0x0c1b2725c75156fd3ecb491ef801668efee1344a,0x8f4160bfeadf5fc2fba6ab0822e54f7fd58c66927d5ea57eb11a493f4d3994a4ab5be3eeeda62c7253e79ad1e56f2675
,816,123515,196773809,1,0,32202253765,32005479956,0x8d8b9d2e5577ad98d7e57ce866418756151b6301,0x854182e94e71f7f6737082b1f2f2148a172b8e987f3efcab86d0c6aa3a8799395beb9e55b4a83389bcd4354f28269ac7
443,817,123400,196549797,4,0,32202643296,32006093499,0xbf52f45fb7fd177754508dcf82755a821d444279,0x85d8b26dfc549ca34b36005f0fc876da00e806318775e1a9128180bf73188f91f49eecd6002e7ee276960e2f1a6fc678
,818,124361,196289343,5,1005,32196289343,32000000000,0x293bf99c8a1018e71a82a9d53c689dea3115cb96,0x900d047a0002c46aecd27801600e0064afd54642cd11041b359100707f28ca38e9d0e682981acddef9ad2a608ca349db
444,819,124155,196263086,8,422,32196263086,32000000000,0x2f5105ced98fd0dfaec6eed6125ab0d35f4e5c22,0x8b5ebed9d6587744f098a5b206c5d3113e75fea1bf8a840a34bad494b075a3b327db2e3b7712d93f77053605dc8c7082
,820,124271,196086779,1,806,32196086779,32000000000,0xa83dc8db3637f79fbe6eebfaf8e7017fe46e40d4,0x92861379f9d20b8b82d177f985b77217f2409d622750ece86113c5304c238024f2716c324cefc941684f525230f203bc
445,821,123884,196043793,0,0,32194323197,31998279404,0xa28e048f911f14fe99648f90a808ca949df5a5ed,0x976841fc372e62b70c024c18de74d354127f659b58294019d360bc212560c53981ba1f0b0f6628d76ae4a436d931de35
,822,124084,196025877,1,174,32196025877,32000000000,0x75c8c9e5c64e9830814446d3b20b71ce3d19a21e,0x877898ad54d1f16e1b99eea5a559521c217545afa741a8f6206a59c8ea27d09c368ac7c2625e3c686b2eb04a8f1ee708
,823,123542,196011904,0,0,32201286393,32005274489,0x5c7666b1a842774318ac43087dfe0ef7eaadc06c,0x98c66d05323fca9b1f010aee785d92fc6d53ed0006fcc6c4f7ad175921c1adc65fafa416015ce7ab6aa103c6195172dc
,824,123885,196011547,0,0,32194290951,31998279404,0xa28e048f911f14fe99648f90a808ca949df5a5ed,0x8d53845e852a34c9e67e1c94d25449fb7e01237e5f0021c2f9f503fd60ae94c64568048c253cddf9e17dde30e61d2967
,825,124081,195968843,1,173,32195968843,32000000000,0x75c8c9e5c64e9830814446d3b20b71ce3d19a21e,0x92792fab4e96112354fe3248a4ae5d209aff6a8b5fcb0940c07973148cb3cabf48508ef21ee1d31bdacebc22dfa3b4ba
,826,124312,195793068,2,817,32195793068,32000000000,0x8b4b6f437fd0e44551ad1acb15a7d0f64cf8fad1,0x8111ff83d56040caf10dd4c45c27644355ee04c9356d7662c00477bb68d010b05bbf16c2c8113d9893cdc8875532ee3a
,827,124169,195614146,1,425,32195614146,32000000000,0xb38e943206b23a2e0456b88b0030885457f8a898,0x9396f81c6292f2682fe3233df79bd551ffcba72b87bd29598e8a797d773bfca741168e7c161161471114803b9ddd568e
,828,124306,195483215,2,815,32195483215,32000000000,0xc8a91e68821cfd4c63a3c1ba4a04ac3eaa79ab18,0x8564e45222eb3a4206668f13b002da5821c35554c1a19fcb9d4d715698cec7d5a22f6249ed1c2ba0e895708db45c0e2f
,829,124234,195456834,0,625,32195456834,32000000000,0x4ade5515303d36758b41540334410301f9e4b4b6,0xa2198343f7676b31be0677b6875612ae99626176493544f81a460044da7560a86e34942d3d6332ccb4fd39b654882422
,830,124127,195435800,6,355,32195435800,32000000000,0x8d6b61de69358cca25fef4b7f583bf3ca95a373f,0x89cdc5bc98f5e82f3ac129057c8589da071a161c89c178a2206cd225da3e9f434ea59238b621994942591829c52fe140
446,831,124388,195361199,5,1070,32195361199,32000000000,0xe5a63dac924a6773ad4db392e3bd0b3da858ec79,0x9113c892049073a184ea3f534d533147106273e467601d733f6e56d9e96317a3a23cd30720f59b24a08cacd5ddee95e4
447,832,124321,195319287,3,935,32195319287,32000000000,0x9d654a5dc26fdc96f07ec8d0ade58646d2dfe87a,0x886e3e2b13b3f21e17755a0eae9dc00da138d67c7ce08d606111c6c1419e62d179f24c0477f4a57bd5de90bbed3a1f6c
448,833,123717,195020695,4,0,32191111053,31996090358,0x51c9645e1432e7557cd982dbba852a488b03dcae,0x97b65a0434f12fe5e8d33ebcad945f21c5dfee7378fd16fe39c27b9044ab9e5f2981892119a4095cf12f4906883a89fe
,834,124250,194924243,0,683,32194924243,32000000000,0xff6657fb62d096e48df19d3fac645b3f250b73ba,0xb6dffec9aebb16c450fcc13d91fb622ad8d957794f43d59945cd87ae1ddda745ad337be9aae0d7968f9cab456be6dc54
449,835,124323,194768167,2,936,32194768167,32000000000,0xc2742c2e57704ffedfdc5483b076d3472e44aa28,0xa3723c69ab17efb15ebae66a5f31494ce5bd85676b5cbad1a14dd3818c67afc778520e2757fd5f888157a0c0e9f4362d
450,836,124025,194490280,9,48,32194490280,32000000000,0x57d35c3a374d76c695445957df1b633c78ffa1cb,0x8e1ad7147e9010d2b6d8472102d58c1e451c8646c4bdb0e60b4c9c836e5664cae390db1fac9c5f669ff38035dc38574b
451,837,123575,194314200,6,0,32199408407,32005094207,0x6cfa9e52be1f4a3b473f54978a886aa7d06df936,0x972668fbffaf156189421d08e531fd98c576bb45cb4e01fc1259ea753439ee2b1695ed1305d56b02dac6227228d3b152
452,838,124066,194276931,5,169,32194276931,32000000000,0x74e9bc3427f4a83dbe872233471d1cb0a3b34701,0xb757f9a7db5f5aa79739596ebafca04ec593286b1df48146e20ed27ded043447a3ee30ebdde7a266b4f96de0eee7796a
453,839,123220,194133941,1,0,32200975767,32006841826,0xd7ea27abe6f89b73866b69d1de66b192086c79bf,0xb8e98e98fe0be7c54dae1f48b434c4ca02cf4fa75549d18ebdd8198290cd74385196530f89ac4399b4567a1069770e79
454,840,124367,193905987,5,1006,32193905987,32000000000,0x5f1b1e2d4b10dd77e441240dd8a6a17dfff70f06,0xb5a46649f4434fe8cd9686d386649cdf5a213383a6cb30e4a5a9ece44aea2bd5522d92737c67472bdfd17b883d18500d
,841,124379,193885048,2,1009,32193885048,32000000000,0x2b343a798cff954f45097c52884658ebe1e23d38,0xae31aa9ea488e5e5850771d65723b3e43acd01167d0b367882125df3c0fd08a79c2ca3f4c1aef3be709b259ce132723b
455,842,124115,193746676,3,293,32193746676,32000000000,0x483b7fbd7df72925ea501d106bd9c675c8bbb79f,0xb00137b58eb33d657d4f3da9e50fb883a74f119ebf7067a739d3598f0b2f4f8b91fe6003316483113a62423210f14cd9
,843,124535,193575452,4,1288,32193575452,32000000000,0x5f19dc21545284060be7aac6f332caa2a54722d7,0xa3320838a7eab2fd46b54531b2407eea2e7535962b39f107cc953b47743de1f777f9722a6c4ff236d1c6b056f402b975
456,844,124365,193549290,1,1006,32193549290,32000000000,0x597fd84de55e9f79ee9070952d5e05892438e5d0,0x8050f09e9e4a2e39ae7d24857f70440c2c94f635bec2894e0007fe5e4d707f7017276fe9d014bc7058c3bd2738b93401
457,845,124377,193513976,5,1009,32193513976,32000000000,0x1c16309a9b272dee0c0d617c7760a35097026152,0xb2c19b801d00dd832c6d7659291753e9151e04b5f1275b1416a27c3eb6c24f3b7dccd47f3c0d31d1b23059b381beb826
458,846,124263,193489294,4,686,32193489294,32000000000,0x9de698091515634357043a54a35146d7ba020fc5,0x862b7609ca511e4a5bc2316ee2e270117e9454a0adefac3250956fc8319e249cfe636bc5d4f25203d87cc44e0c514466
,847,124078,193437411,0,172,32193437411,32000000000,0x75c8c9e5c64e9830814446d3b20b71ce3d19a21e,0x8e118fd902bf8072d621368d1356b0f63e4bedcf48824d2991930a541b3b6405b2279cff16fa6b5e2109128cf05932fa
459,848,124372,193414597,3,1008,32193414597,32000000000,0x4b470f059f1a05bf3e1e0eb4f1da1e7ad6924ad4,0xb5d298f8711a2d3e7bc14f28c689147275cd1754505002679141c9dbd2e362bd38c72a739d0e02a5f9e1ac2b36d8f666
,849,124185,193284412,3,550,32193284412,32000000000,0xcb64923781ee85e71b85ae5953f30abcc22b87cc,0x8687d09babbec5a8a49b4be3d0847acbdf00c8e1c6b625bff67cf97268f329b5088505744cbb8cac6c01eb86797a2650
460,850,124326,193131538,4,936,32193131538,32000000000,0x2e4485b800f7100a6e6258f036e405cc70db8b71,0xa7543fd70e04db224176555c116d141a6c13f85e441b01eaa1b92ba372b6ef180d1ebde624940061122201f86a4af657
461,851,124426,193042335,3,1260,32193042335,32000000000,0x649f5210e26f7052440402e6ff44f70b31ed6163,0x8124101e0c90fbd31d95bc169441c3a003c9d2ce17c7886564c7a604f221a9cdd107c213cfcd31287397f77526ea1652
462,852,124186,192902131,2,551,32192902131,32000000000,0x520eb411a4c2db1950d0ef33e3e1355d00d24692,0x84ead68b122595c3795d106e179a9bf22559bcb8502eb11d3327bc87bf4e119364799b55724379470e0d583c274b0fc1
,853,123221,192622953,3,0,32199542629,32006919676,0xd7ea27abe6f89b73866b69d1de66b192086c79bf,0x9543cdfda35a0b95763b488b6ce35465b4e9e9a73a226cf872863638c5a5e9a3fc55886f02ff4ff4adc419747171d160
463,854,124317,191905716,2,934,32191905716,32000000000,0x56670ef8be7a8d30fece9e132a0a0a8d2bfad63e,0xa56b8fd652742a19327e2544e39232efda37386dbdd3e0bdca11579b4ad2c6e849e1f26cebd13e339e707a999be44e69
,855,124330,191614551,2,937,32191614551,32000000000,0x77e88c6b9c638c087944752927ec5a5b5dc564da,0x935a6820b0b1778a2661f3d86fe5c41f24399a9b43f84a8a11fc8ef6e667ee8638a8b30c0f3748b125b4f74e3668ec31
,856,124032,191469934,3,49,32191469934,32000000000,0x74e9bc3427f4a83dbe872233471d1cb0a3b34701,0xb17926d9cc7fc8c6cb0b4d06e2b8d589bcb79e6fc8e604ca312b2509d11219c96420a8d3a8b413734ec59e7b0771f5ca
,857,124329,191322455,2,937,32191322455,32000000000,0x77e88c6b9c638c087944752927ec5a5b5dc564da,0x83ca9063c41d1d27a2dbbffe262f6765b33cedd2d590126a837a7129365f70d19a1a3bb07f39f7661b45209e0738d7f5
,858,124344,191005650,2,941,32191005650,32000000000,0x13f31232a569867b037d51c3ff11190fa6e240f4,0xaacf187551f11dc150ef3c5af4a112d1a26edac81179030f773a052081ed4d271421dad3f0f9b49eefb71ec35b069fd8
464,859,124327,190746749,2,937,32190746749,32000000000,0xbcb72077eedfff3ae20d12c3a2d6a5c91fa77d4b,0x9943ae5992f6884d0ee66c9a62afe51253d736d4b36f44cd09ec10988efaa19135df8d3e632715e36a49d1b9792c58d0
,860,124362,190417782,1,1005,32190417782,32000000000,0x293bf99c8a1018e71a82a9d53c689dea3115cb96,0xa94db10840daf8ab00268ff448add734dbb7efbf5736d5248e8cf60eea9df2ea5e253aa864f87b1e2820fa9fa7b56ba1
,861,124138,190039624,5,357,32190039624,32000000000,0x74e9bc3427f4a83dbe872233471d1cb0a3b34701,0x86457475eb3ffd7f88fd654483c42f3a5b52015fcff2b1efda0faf10165a8fac6be0bd32e1a1d1ea1c4e75cb557b23b1
,862,124533,189940870,5,1287,32189940870,32000000000,0x2b343a798cff954f45097c52884658ebe1e23d38,0x8355f1990ab7fa9bc686ae1fbc18b3bd0ae112977dda7e6270f5515555e31a3816f379e491379b2d7e511ee0b9d5cf51
465,863,123677,189928620,2,0,32194472953,32004544333,0x52a6b6b8a46d3fa3a4d87e2f19defb75fef76c94,0x8ec2a207eda980ae259378a55a0574baf1d0be7e4b06df65e949baafe23b6380e22efdb2eb00e0c02abee6433fd6ff84
,864,124163,189840371,0,424,32189840371,32000000000,0xb38e943206b23a2e0456b88b0030885457f8a898,0x95fe9b0d75265d7e17215a7c73076c84ee057c9e44aa9e2934ce30d98b1a1ac701b553847cfee49c7e8d04861b3ab363
,865,124067,189757782,5,170,32189757782,32000000000,0x74e9bc3427f4a83dbe872233471d1cb0a3b34701,0xa0c1bf44af9f9043be2d36be9b830624ce296d1d0a9a5e45a107a67ec78a4bbba6841308b9999e5f6d1899856986f797
466,866,124539,189571988,5,1289,32189571988,32000000000,0xfc47e1bc8be9ffdb8818679f597ac4c0dc1b2e1c,0xa1ffacdbc2136a447afc3b37caae876e1fad1a93d2e3f603e59f9d34b876e1e214399866cf92f56bd5e882a54da4fc18
,867,124375,189420536,2,1008,32189420536,32000000000,0x521deb0d352d70868a6c3952b3bd478f11eeffcb,0xa24bd4bece18ff7cbc9c133fad84cfc06a385f7041e9f6d4e3f4135ecb171dea912d566f5215373ab53fed98f982e1ee
,868,124534,189216666,4,1287,32189216666,32000000000,0x5f19dc21545284060be7aac6f332caa2a54722d7,0x8e8bb531651d766cbc6d24e62a1558376941cef0f036cc0d1efb16abf6bc21affbf6fdf4cc76475b94617b9c63896ebb
467,869,123572,189010164,3,0,32187644901,31998634737,0x19c403677a2fc5f730a4ae5b2869d78f2d39f1ae,0x848b5821b8eac4c2be659db991827abd9180052c5e6f5cfafe8d71b59a783549f82e09dbd77f713f4dd48efe30884ab3
,870,124031,188954258,1,49,32188954258,32000000000,0x74e9bc3427f4a83dbe872233471d1cb0a3b34701,0x996044305190719a1e93a8adc8de3df225dc19f1b5d30763e93478dd3b8b90dd02bab14892ddc03e235499f9882f6616
,871,123844,188700874,5,0,32190871027,32002170153,0x57d35c3a374d76c695445957df1b633c78ffa1cb,0x90ac318a17a883fd2f8af3afc9d27602db96cfd85b67639eaa93dd8fb7dcd6e810302c99056fc22a954ca707ca5741bb
468,872,124328,188651767,2,937,32188651767,32000000000,0x1e3dfdc3fbb17e03ef16a748a33a15e470d72827,0x83b6c05df8309ab7ec937bf76a2ed84ec87c42c289680000342065cd56ed290e4e77113a7aa6d6286fca4fa7c249cf07
469,873,124315,188544872,0,934,32188544872,32000000000,0xd5254ad60e0e7c66a12658f2278132d17e858b1f,0xb391a132adf33a6df1514f5b5e11733cc8407c46c497340ec5ec58380fb8426e73adcba46ca794f46caad230d6c9de8a
,874,124378,188355258,4,1009,32188355258,32000000000,0x1c16309a9b272dee0c0d617c7760a35097026152,0x85fa2b7ac844700ab475802916b6622b6b33b0c6ca925c42f10121c3971be3a5aaf6f108bf0b0f51a3273d938528a429
470,875,124319,188268991,0,935,32188268991,32000000000,0xae708e15c522d14d9f21a1665eef0ec80fad654f,0xa668a0155c7c62982e1c67c145cd5f7a77aa64a5effa991d04863561f8ae0fa79926bf804bb5f97d0c1e34be0659df43
,876,124221,188267727,2,622,32188267727,32000000000,0xcb64923781ee85e71b85ae5953f30abcc22b87cc,0xa9b33a345395e23dd25827ebca55680884e4ad530b24c6a45be5d720121acb31fe83fa52333af531a19160b85a30630e
471,877,124324,188181155,0,936,32188181155,32000000000,0xbb1133f1267bd0e16198b0182cb582818f3401e8,0xb24f9a39cd5548233ecc3cb54fe82c9e834570054a7d380042e89d769a62fd67e6b41b366866d6b5e9b0b8d2c3ba06ec
,878,124364,188001179,0,1006,32188001179,32000000000,0x597fd84de55e9f79ee9070952d5e05892438e5d0,0xa2152d76e6811d508fcca8e841b3192afbd531f2f464da4cfee33a04b3ee230d9dd3f2b3eff43c3d9ad4b5031f4bc2e1
472,879,124047,187561686,4,165,32187561686,32000000000,0xcf1e25203ab2d6ab867256b05e75da85c18daeb4,0xa6d2c41b41425f55b3068461b31c09a323368511e22a9b1daf40127c3bb34f46db22ff8887e9a227025cb9625817d4c2
,880,124532,187401631,3,1287,32187401631,32000000000,0x2b343a798cff954f45097c52884658ebe1e23d38,0xb059e8bdaca86450b29d71110e8001d2fbf8e912fec01cc1073c94bb308749fa286e8b5f11451466fd86a7d1cf71c2e0
,881,124129,186987858,0,355,32186987858,32000000000,0x8d6b61de69358cca25fef4b7f583bf3ca95a373f,0xb4f100b92573129817626ee5b41720e10fc736928a1e41fa28fb60c86446a16bcf0d5dd606b2a826c408a546db724b41
473,882,124161,186948754,5,423,32186948754,32000000000,0xe28b9a99fb623969839cbd6c1adf406e17778e7c,0xa1143aecc530009c8d541b1a7b9fa2898534984e8f997add3533114c6b32e54166e4b2a8a4d522efddee6d2c29370447
,883,123852,186901594,0,0,32189030352,32002128758,0x52a6b6b8a46d3fa3a4d87e2f19defb75fef76c94,0x89a7e988bc37c190dab4a18f9f23167b14dd37536751c9b1b78ac505854896f9e7e7dc7a2ed2e4a4562a27ff36c82522
,884,124113,186844304,0,293,32186844304,32000000000,0x483b7fbd7df72925ea501d106bd9c675c8bbb79f,0xa446f6adcc4a6c07c4b736b222507c21aa7a58407ff6fe0ba77249d0fa06cbf0cfae03cc7b77046bbc9f922d1c3b3161
,885,123813,186609891,2,0,32189033233,32002423342,0x57d35c3a374d76c695445957df1b633c78ffa1cb,0x8438a5b35df3c7c485602ec829b041cc550ecfb9f8b918f6a08db67b23c59b671dd6e57d152e64d2a1656bdde36fdab5
474,886,124352,186527727,4,943,32186527727,32000000000,0x1afdb3b1a0d7a12b1c02d6e0987a46ab48553466,0x99698bb9704af5d61f7293c5800f62f01523cd6821b203b58e3fb75f337a283a3bb3869c8afbf29873e7d4e7dd534bf6
,887,123845,186423987,6,0,32188522860,32002098873,0x57d35c3a374d76c695445957df1b633c78ffa1cb,0x82c2d17f22029ba0865bb9222a3e2d6779e0f47322a478e9cb3091837f2f86eb1fe0b922f047bb2ab9a785b3abb9681b
,888,124122,186349289,4,295,32186349289,32000000000,0x74e9bc3427f4a83dbe872233471d1cb0a3b34701,0xb7859756f05d082baffb74d0886bb309899f4961b4011855de27a3cfecf32c608ea8751fd58a3e5a044d5e002fdbf480
475,889,124273,186341718,3,807,32186341718,32000000000,0x6d0a536cf784ecf066ea9ed6d0fe0535760cdaa1,0xa847758f08a1f592754590205a594c41263806fd5c4e5104e013bd3addb037cc1d780592a15105dd318df7df1248650d
,890,124103,185637638,3,230,32185637638,32000000000,0x74e9bc3427f4a83dbe872233471d1cb0a3b34701,0xae0fa5330baeaa28f7f10f1c50fb98aee8aa09c2be81cbee209e1c393df104a982cb2dda450892529720b2ee657951e8
476,891,124389,185633319,0,1070,32185633319,32000000000,0x562083e79f98d6fcdb447f5d9a65af43076eb957,0x8ad205dd75d218b8549e02f5971fe17bd98921794888e08ccb84a5fb55ff9e39b220bbc4524e28a4fac27bec31adf72c
,892,123718,185511602,0,0,32181601960,31996090358,0x51c9645e1432e7557cd982dbba852a488b03dcae,0x83ec61fd9907595d874884b637fa465010c9bb3b6fc96157ece219a562932418320f1051170c376891fb409334177489
,893,124390,185500724,0,1071,32185500724,32000000000,0x562083e79f98d6fcdb447f5d9a65af43076eb957,0x8ceb0a90aa08b253ef90abdd43160206ec0ba8cbdf7f085b0ae8f801bfdbe67f4e52bba11baa71560bd0191ac2be50a7
,894,124238,185496427,2,680,32185496427,32000000000,0x6d0a536cf784ecf066ea9ed6d0fe0535760cdaa1,0xb9fa7b2f71356d5860430df7bf509e23cff30855d99db360ea7d22bf09bae6ada866c0d75272cc089089acce37f07aa3
477,895,124314,184962843,6,817,32184962843,32000000000,0xaf471cf4f800261c24ada69791e9813584721a6e,0xa7e806b84ee4dfb53addc456a176fdc12349a1047699300f805aab8f7a05915437f25e5d2107d0afe93a530041287107
,896,123819,184933209,5,0,32187331138,32002397929,0x57d35c3a374d76c695445957df1b633c78ffa1cb,0xa58c1c46448aeff68dc9c0b83bd368bc0bfa3008baabc2fca40ef4e7808f8c99f1ae9a4dffc611dc9419c509c09d1725
478,897,123726,184894009,4,0,32181033573,31996139564,0xa77f58eecaf3310e4ee44a6219f3e36c1304fcc2,0xb3b7faf99070b87bcabf42d9e4a6ba36220d50a5db18c513d6d205c272ad0efa2e84ee4073350ec4e287feabb32adb1d
,898,124546,184565040,3,1317,32184565040,32000000000,0x9af8c16a29af0b8a7caf139b1e5e14c387579742,0x8554d5add1484145b6922642bf750df43fb1fd6bc3baf7fef3c954dae55b7dccd3be2774389c34f3193f73886a4a8059
,899,124407,184041053,1,1256,32184041053,32000000000,0x3f6e64cabfc18106c3ca38bbd026180da1ef4969,0x80fb8d2165a00413b9dc2b6491f7c486558f52465250f1ee102079f528863abed88e2f0f6a972f866ad844859cca66d1
479,900,123313,183927363,6,0,32190355434,32006428071,0x57be3107e08effeff4cbfb0de6728865cd49361c,0xa5da7088992dfd9ab298b7485b175a30a0131dc38e5e7317b36af607f076a6d0736c63a41656f1f782d4e8245892637e
,901,124102,183702676,2,229,32183702676,32000000000,0x74e9bc3427f4a83dbe872233471d1cb0a3b34701,0x8891013da53cf1dc005c609451787d51e9ce9e283ba141f23ebc9a36c9c03efd1af452cb494ec54a8125d40876949089
,902,123727,183665288,4,0,32179804852,31996139564,0xa77f58eecaf3310e4ee44a6219f3e36c1304fcc2,0xb0cd9ce432203b8ed51f35894de3ceb999e078dbdc3c94815dbf93e99fd827eba59b299a3d80d7f07c526d04de1d3985
480,903,124592,183586414,4,1585,32183586414,32000000000,0x1b8976ec8bc31aad9d1831e7ffb7a89e089e4e5a,0xa42035d7cff0480b9a94be190fbf69b1bb374f7b0bb4678c5af083500047d6cb49c9c2687ad460d42289609ab1af5e91
,904,123407,183395187,3,0,32189372679,32005977492,0x6cfa9e52be1f4a3b473f54978a886aa7d06df936,0xac846207e40da88f7f564b02b261a71ce40b74d5edf9624af940d9f4d4fc18d9bd73867834c08270dd64f0b77b5b61b9
,905,124538,183003325,1,1288,32183003325,32000000000,0xfc47e1bc8be9ffdb8818679f597ac4c0dc1b2e1c,0xab8507807d18e708682cd89461f7c5a0e80c64f2824f16ed7ab690d2c84be9e832f1cd302d2e48c4d12058f691ac12e9
,906,124542,182991906,1,1289,32182991906,32000000000,0x29a7aff9998170f96208a48d6c3e99cb8e9f5e81,0xb727c0eea047442278e18ecf520855e6b3a45518c17ed96580680a7b65ab6d6173a117fe29243d729bd513139f59a9bf
,907,124197,182979077,2,553,32182979077,32000000000,0x6c4cbd214bdc9f0905bfb29eb1d9bfba58348972,0xaa393e37eadde14b7ba0bf991978f63d3116eec30d893e535ead3669335baa9d692116221b724533e49f44ac25117049
,908,123862,182722291,5,0,32184797745,32002075454,0x57d35c3a374d76c695445957df1b633c78ffa1cb,0xb506099692f44f79127a2aefad890d1f44679247c3d0fb6b14f504e5da63fb4293cfa94ad787fae2e9effecfd19fe9f1
481,909,124022,182477271,2,47,32182477271,32000000000,0x0e4021551bc525c3d151a28db8cd9f7786fbb8d0,0xb2523e65cc0a914ce0565713e06c15931c744373631eb7102fcadde24b15733db412d69ce2cb38a6f42aa89a411751a6
,910,124291,182403511,7,811,32182403511,32000000000,0xaf471cf4f800261c24ada69791e9813584721a6e,0x8a1cf5e0a63be5e811caf1c32ffffd6385e70569e8d29c24b1cc42f5d0db6991bc108508c2c5a4d9c394d7e58f0d80e5
482,911,123950,182361928,1,0,32181034662,31998672734,0x74a5011587240ffeba5740dc06e0bc1cb3314049,0xa191e8e15eed1bef623e907e56c07a8de01589022ca6b3d5d241a0c67b6ff571c94ffc84f6b3cf545f31212a7112eef7
,912,124427,181725850,2,1261,32181725850,32000000000,0x649f5210e26f7052440402e6ff44f70b31ed6163,0xa50f0919086d66a35bae794915159e8cd784c9cf6dd6132ba91e959f600855c3e21008ebff1812f5833023b2157e4c8c
483,913,124564,181480574,3,1447,32181480574,32000000000,0xd217341bf14f38e24d840cb5bad608275eb634e8,0xb699e066c5b9ff80c28a6f404504abfdfa463b4f94b28dde9aca98ddce3e70fec67f747b5a7b4295286986b1b76bb1bc
,914,124545,180846380,1,1317,32180846380,32000000000,0x9af8c16a29af0b8a7caf139b1e5e14c387579742,0x86527d32c56d908f2fa1597868111446da98670e6bed40ff3ac03ce684ae6ddc7e8a57abce2eb656127db53bdf4fbfac
,915,124026,180762317,6,48,32180762317,32000000000,0x57d35c3a374d76c695445957df1b633c78ffa1cb,0xa196973c98624a12eddbe66cb3c46d332146e249b65dd8849dd5bf41843647858eabbaedc9e7629370e9082763cbbab4
,916,124425,180514280,0,1260,32180514280,32000000000,0xb28dc5135a76a062382444ef1457954d99241fdf,0xb55cac43212caf12ab624f96163a63d1de26f57c891660770cdd0450fd40329def7ada061d77f5d6bf2990aec027e678
,917,123873,179896987,2,0,32181831107,32001934120,0x57d35c3a374d76c695445957df1b633c78ffa1cb,0x86b8211b0d83b7e1377fac6bebac2a71e85dce0561d61a7e2a99f31f3c4afe369b32028a50d60053e8f191823390bfa5
484,918,124558,179607141,5,1385,32179607141,32000000000,0xaa6d9c64c580e93c1028ef914a52d9cfd84b323d,0xa9371550085e56d702d3236ffaf7244b698911317b24a7595376a469a5938d359b40707a3e92fe45faddebc19ec30505
,919,124023,179231350,0,47,32179231350,32000000000,0x0e4021551bc525c3d151a28db8cd9f7786fbb8d0,0xb4afadae905b728fdf18c59fc8e23395121dc1a21057362295c0f3ca1966cb97c458674a36cac8936197d7fc630d3124
,920,123294,179212665,3,0,32172521270,31993308605,0x4b470f059f1a05bf3e1e0eb4f1da1e7ad6924ad4,0x898ecca319b259d0b2c1e6b9ae077fd86c7fd2812f98aca5cbc0fa331776f5131fc816972b081074211b68d8e2448349
,921,123934,178909329,2,0,32177483738,31998574409,0x74a5011587240ffeba5740dc06e0bc1cb3314049,0xa14e996d0ce3a27e02b01fd5a9ad65a37d81ebb0bf6ce443dc9530d48d91b3193e7c8f79a88ea13f0946c4f867f73311
,922,124267,178824571,5,805,32178824571,32000000000,0x52a6b6b8a46d3fa3a4d87e2f19defb75fef76c94,0xa734472d2a5ed692a664ed3219a40b9022eccc9b13c44c5723665595ffde2ed45ae6edcf3d416d24a93984296b019dab
485,923,123790,178363343,2,0,32174896495,31996533152,0xf0a1bb19f8cc0813781277dccebcc3fb659d79e1,0xac7c2148e71cac7a9275acf04b5b5281924bea3b88b15834d5e61592704a007197a0111d4e35672e7c89ab47c3af212b
,924,123312,177796469,1,0,32184267293,32006470824,0x57be3107e08effeff4cbfb0de6728865cd49361c,0xabade43ea3f9323844e781d962f417a59cbd2cc19670c7fc31218fcee25a69fa5c34fc5ad18c6a632b9ad5210813a514
486,925,123437,177564760,0,0,32171931903,31994367143,0xf0faa47834a477e42296602d67a2299a4d32cd39,0x82296bacb75cb64b66dfc18094d9522fc37cf3e6ca8991da98012c3266976737a040ddf39acf460a0631f5821cad6187
,926,123436,177503696,0,0,32171870839,31994367143,0xf0faa47834a477e42296602d67a2299a4d32cd39,0x857368b091afaa85c542cebd84aac4c319ae8a44f8ddb2d87b147aedc8e12438f5f8a6f21155b15c63cfca626147f8fd
487,927,124552,177390346,0,1384,32177390346,32000000000,0x1bc8fa9bfa62ccff5633b7a219f10713ec5601d9,0xa40fd3d6b375eeed52ac193b836febe9b3d5d69a9e3482369986446a41faca6beb61a400a79dd473e5ee7cf00b34ee16
488,928,123495,177387158,3,0,32183016661,32005629503,0x42e1d6de7287938a7cdd1ec76f0b6ec0ea429230,0xb0446bd53ed628a7d40588b100201e515ee688c61e52710a5816bace44a7769fb5764df3cfe07f1cca5453686f57c794
,929,124162,177357280,2,423,32177357280,32000000000,0xe28b9a99fb623969839cbd6c1adf406e17778e7c,0x839abf4737402ceac8f69a09261678aa7002b9433defd99f0049741ce4a8057d6a9ea1236f62ab1bddfd45e2acbd0782
489,930,124634,177338051,6,1833,32177338051,32000000000,0x62b2ce7b93f9245c949514b124b282f0e38b2553,0xa277b70e2477bc994701ff87580794dc532ff89240dc42768acb14b0e35ae1c165a160ab5a8b66cb611406242815e372
490,931,124553,177219703,0,1384,32177219703,32000000000,0xce019d95869b2f077e216de8bf55651951f1f9b5,0xa24cd44cb1408db6804454def8646f11b93df8b5b4137f2c2107ae8a27bd3c28eb63ecc6085f47a27a5e574daac51a29
491,932,124397,177206900,3,1124,32177206900,32000000000,0x5f375046a8eafd746a2482a31c5587116ee810ab,0xaab552045286ea0480a79795f77f7824c73e4348bd7eb769047503cc5418ba2abe70717ab077fcdff319c1d9d0e1cd56
,933,124578,177168527,4,1581,32177168527,32000000000,0x27a820b66356350bdf20dbde380c53b3bfda28ee,0xb9bfdc535855e05b9cdf5b318e259ed857da8cbe808df2710a2bd41303adc82b8c69a698dc0987ad95fb2827ecf93a9e
,934,124110,177027954,2,292,32177027954,32000000000,0xf0a1bb19f8cc0813781277dccebcc3fb659d79e1,0xa6640b71532755c89c0fe1a70867b473b7db30688eba0811be32954dfa8e3c8a47e047acc17243e69433d9221d22c07f
,935,124392,176980695,1,1071,32176980695,32000000000,0x1afdb3b1a0d7a12b1c02d6e0987a46ab48553466,0x8236ae78f653cf56a105a07f398c03312048fb0e0bbf11905ce437c0eb18ab27fe80b5fe20a87466efcb837c79af2718
,936,124123,176813539,0,295,32176813539,32000000000,0x74e9bc3427f4a83dbe872233471d1cb0a3b34701,0xade0cc55a7d38e645d77aa375891ca44a7350cdfa842384535c228c6eeb3004ca05bcc7ecd48be3acb9c48bcc613783b
,937,123875,176723622,2,0,32178682086,32001958464,0x57d35c3a374d76c695445957df1b633c78ffa1cb,0xa367426ca336af325d7ad926e9bdab0a222447e96f13b83f3812440b6778e0093fbfd61c656496722a14fb3bef141b98
492,938,123386,176722742,1,0,32182891200,32006168458,0x0d7526770588e80c4963f65ec4ccb9604ca629f4,0xa3e1df440dc8ad4e1c4dfc57a84e32718e4e613ae491705ca3e3863c6f24038c59297cfd3eb92ca72863fd3fef525c3d
,939,123863,176697980,2,0,32178772401,32002074421,0x57d35c3a374d76c695445957df1b633c78ffa1cb,0x80ad5253df3238113cc71fba1e094f3ae5662364f3a85c288f3823fa7ea11af04b46aae11fbf39cc44ec0c355d2c479d
493,940,124383,175844167,5,1069,32175844167,32000000000,0x616f33e05128ad81faffe30c27b4c91cba46d3d4,0x991d675cdc27617357d8a45106b1df5da0017ee0654b619bfc9a7b23a9a97944edbc2f5d555dfa8650b011544af2dbd3
,941,124600,175764707,4,1704,32175764707,32000000000,0x3e12201a639762a249ec88bbc54a279f37e5698b,0x98e7a6470d5d27f0f508834f9f3a88eb46ba09c603a6549f259e3ba5166eb28cf21f43abf202b6a7c42a5559726634fa
494,942,124318,175492361,3,934,32175492361,32000000000,0x7ff8519a897e47f7cbb528da420115535a76c0a7,0xb149549f56cbcc9c087c483e2e310238881a8633986c24bb5711efa7b40870ea714362f05e6531f6384d060fdfbaa2aa
,943,124644,175205779,5,1898,32175205779,32000000000,0x9af8c16a29af0b8a7caf139b1e5e14c387579742,0x8ca7062eb23025148a36669d904079ccb4d0361138fdba479a3803a7425141facc7da3542a2cd717f11087e195753a8d
,944,124692,175045324,9,2090,32175045324,32000000000,0x724e42e83c36f5e23102fa8ec6352b6b121b8777,0xb9720870ae554d5a99630bf61e4f513409da96b4b66e89fd35d67d92bd13fc314c85c1685dd2c7a0c60a144ae0ad8bea
,945,124139,174989540,0,358,32174989540,32000000000,0x74e9bc3427f4a83dbe872233471d1cb0a3b34701,0xb3e492ec9d099408ebcb955817fb260bd8e201022e7686873d2c84cfc853fef7327610de185a347406a139a38773a405
,946,124577,174729631,1,1581,32174729631,32000000000,0x27a820b66356350bdf20dbde380c53b3bfda28ee,0xa6057d0beb3054f33ba38d3806a48bb3f0ffa985fe37874ceccb3ce1b708a8d50c341d4114c8d4d197790805f2131873
495,947,123507,173727823,5,0,32177904781,32004176958,0xe1f6c875a8a52c4d1dc9af0ed43448da5820a1b2,0xb3111ecf103b1613e4fec51cc43cace478fd86c7c29e170f7732c8fc17d6a04e29ee8061ab18d09567b5847cf10a2a92
496,948,123851,173504078,4,0,32175650556,32002146478,0x624b1eada75758b08ed62171258ce83cf0b921ef,0x843a1326e2155712d4533b614e48b570e785c959632430c3e67efcd387babd203a7dfc9bec8272d20a1b03b7d194cbaf
,949,123820,173226521,0,0,32175499201,32002272680,0x57d35c3a374d76c695445957df1b633c78ffa1cb,0xa1e1dcd4d73c946ff665f2fac41073869ab56b517d7f8f322b740086863c13e30e4c5e9d0982d74c0f282473e07d8cd1
,950,123850,172686509,0,0,32174813153,32002126644,0x57d35c3a374d76c695445957df1b633c78ffa1cb,0xaf147e2e0ab23095daad35493f9cd2b2319c99a65073098e2dbe99188cf55ba3b588ac76171423d546135b831dbb7421
,951,124678,172370715,4,1966,32172370715,32000000000,0x724e42e83c36f5e23102fa8ec6352b6b121b8777,0xb813a83114d50939e29bd870271e4c7636968319f6422e148e211977f2c835a2452776dd3139d5024567e5e22f0b87db
,952,124536,170822253,0,1288,32170822253,32000000000,0xcb64923781ee85e71b85ae5953f30abcc22b87cc,0x86fe6e3fdb600fead698a03bdba9c9f6cdb40f261c981988c9fc01628d58bc023bedaf232190d85c9400788e7bb143b4
,953,124633,170703577,2,1833,32170703577,32000000000,0x62b2ce7b93f9245c949514b124b282f0e38b2553,0x931fc5b9cddd855da379f1f63c61c58f18eecb2a1676bc4a41534c7cb2ae58abfe095eed340c4f0ed0f6811a2d333dd9
,954,124624,170663584,2,1770,32170663584,32000000000,0x2f5105ced98fd0dfaec6eed6125ab0d35f4e5c22,0xb6a516334d0de6bcf0629c0aacf3fdcc883a7c8a2f32f97af02468226c65a33d97089a2ebcb0740c0c9930970af68055
497,955,123505,170524397,2,0,32174648546,32004124149,0xeb1df57bb04a5d48068f128912180127eae8e425,0xb4b2eba5f4bd1d2613f36242ae73835957ffb6f1884c1fab3d0dc18ab35fb1b5e967e5efd40162778b210a9ba18adf6f
498,956,124414,170369973,0,1257,32170369973,32000000000,0xef1a0c4f9608d99cc17a63409e322439516198b1,0x89518fa225899a101df6747d6a289e3cb775bb5517cddc16989acb643436770c13f4ec536bbe5bbe22a331eff72e0ead
,957,124689,169971966,5,2089,32169971966,32000000000,0xc2d56d0410eeb2ff025ef89bce3f5171d6332ddc,0x996433f04051482c38cccef0e56008146b4d9351690652e2a6cc374da2b0b4cd97cd7abb7ea7ab13b134cb3ff659aeff
499,958,124054,169912991,4,166,32169912991,32000000000,0xd8282c6e954804f814e913df77968a30e45c1595,0x866dbb3cfa9d77baa6a122e1d9c36cffc3892321731fbbe5ff632de65b5e0071f5d5cc8df673aad03e6a754238062306
,959,124266,168829620,1,805,32168829620,32000000000,0x52a6b6b8a46d3fa3a4d87e2f19defb75fef76c94,0xad527172a2c8fea2c91424ada424d757e3ff7f3f13266852e4cd0886b648faf6095ef775d71cae7af4dc0969d54a80e9
,960,124320,168634705,1,935,32168634705,32000000000,0x7ff8519a897e47f7cbb528da420115535a76c0a7,0x99fe2f10da5c9dbc1cd23aa8bc69aabc51bc01bbe6eb91221d9ca2a72a144d1a495b3d0e02682c50c9a3ce2d379984d1
,961,124607,168327637,0,1706,32168327637,32000000000,0x27a820b66356350bdf20dbde380c53b3bfda28ee,0xa0ffdc06844ec8ce4f92e583006402a03cb8622a3d3e8b1fddf2eb70aaa90ad3777e28bdc446958112e30686bc3bcf36
,962,124645,168294010,1,1898,32168294010,32000000000,0x9af8c16a29af0b8a7caf139b1e5e14c387579742,0xb00d03ae275ba9ef46a3b25baf0452351d52ef47ed0d4290b0051f58a980a4ffa87ed04599f74fee766d4dd139f89f3f
,963,124679,166617617,4,1966,32166617617,32000000000,0x724e42e83c36f5e23102fa8ec6352b6b121b8777,0x9481e28937ae43065b47da95f32f9553b22d1243edcdf4f5a286ae27e4d46b874c0111e5e29e5c2ed1d38f2199ca5101
,964,124272,166405315,3,807,32166405315,32000000000,0x7ff8519a897e47f7cbb528da420115535a76c0a7,0x8c3e9ef55168639f51babf859d5afd1a9baab5ac4b05f7b95dc00403c1aa936835f46c313e9748e366eccc783aafddde
500,965,124011,166181843,5,44,32166181843,32000000000,0x336e5ddb7215ff68b32a07a5e10995ce653a111e,0xa55a13ac91cb18f434a0268e47515c34641e4349e7c42e1cde1db6e5bec6c6997f982e6ac83b4aefd0c74b07bf147326
,966,123508,165393288,0,0,32169355150,32003961862,0xeb1df57bb04a5d48068f128912180127eae8e425,0x84442a6c08eecbbcac6e998bb09d2b635d20690d4d4bfcbd9efd13947817ba60ad54590a6d5f920c2c134e29caed765c
,967,123504,165348112,0,0,32169425929,32004077817,0xe1f6c875a8a52c4d1dc9af0ed43448da5820a1b2,0xacaf90ed0c0558a32dee09c812edf944d14e26aac663cf737ef502c3bcc4048c705198675610a3885e8cd60a2fb5ac2f
501,968,124700,165298748,2,2155,32165298748,32000000000,0x6cadd5863afe2580227b338130578263b0458ec9,0xa76a8558ad6d2185558f4b397a9b38d1a260c22bdcf5e31d17481b3cdeb39c6ac06e6afebbff91f8ad68fe8b9103fb93
,969,124126,165293060,5,296,32165293060,32000000000,0x624b1eada75758b08ed62171258ce83cf0b921ef,0xa8e9982103b50e443cf1812ab1c70ab4b548fbfe49b546aa611c5041b187dedbef7266ecb9578df7b68489100bbcbd66
,970,124680,164802700,2,1967,32164802700,32000000000,0xd974c75f228390090080801675b258c043032a46,0xb02db08d1e77ddf140553945e80baff3b5cfd2d8d8c7fb052920295314e2c0cc8f525a3e7cfb5ed3d0e274447949cd39
502,971,124649,164769200,1,1959,32164769200,32000000000,0xed720c6c6811e0acd2ce15be0e7d6284aab3fd45,0xb44f5f6d6baee0a4891487413f3eb01c2a252d9c593e21b547e87c3b8cff1b99557b80f6ed356ffa710894d495496b25
,972,124694,164653221,3,2091,32164653221,32000000000,0x521deb0d352d70868a6c3952b3bd478f11eeffcb,0x979e4849fcb893484165dea5e1b8bfc681a2cf5f4d0bd6f44b431f5a34bc842da68a4ba4ab690fcd8a973454191af444
,973,124693,164446057,3,2090,32164446057,32000000000,0x521deb0d352d70868a6c3952b3bd478f11eeffcb,0x89107624d90053fa1e0efb6b015baa806b07aa4cc93b10d08d37783971ac1ad6e8f93c4521b6278fe2e440b42011ba29
,974,124648,164180488,2,1959,32164180488,32000000000,0xed720c6c6811e0acd2ce15be0e7d6284aab3fd45,0x9739880719c5fc1d547961ced32e5172a5c830e85bbba46db860b3d6da37406ca4e16a8be6593a47f45d1f2c4eb939d1
503,975,124691,164003402,2,2090,32164003402,32000000000,0x92f67205dd7eea79972edb01beb895bb5abbe97c,0xab026895fe6ba6f63d958ecebb82839cc9ae202c80445ecc89b0a628e4283c2165e764200d27391a87a3fa9e40858724
504,976,123097,163364272,3,0,32170973217,32007608945,0xb1255a45de1ba5755a2bd68e6725c14a2fc5b422,0x953e4cbe4a7c9e840ddac2a57a9b5c605f0cc97e08c35f78dce5bb8c81d059a7becdf3a6d01817a163705e6c9a43b673
,977,124384,163343028,1,1069,32163343028,32000000000,0x616f33e05128ad81faffe30c27b4c91cba46d3d4,0xb222b4ba44ad38090a46c329e43108ff69c0a481d2835c790d256bbb600aae33bcc3bb7b362be7cde2e29989b6441f82
505,978,124125,163081864,4,296,32163081864,32000000000,0x2903fd56cfe678c41ce82715ad6b1bda06f35aa8,0xa050f7b876198dd5f803b5b7b333b9412cc8828adc76d2070a9312f5dee8351044c3c31df4440e11574d3c5e241618e5
506,979,124697,162775239,2,2091,32162775239,32000000000,0xe13037ea3f3978f401b5cca0ca775341a0fc1d05,0x8c881ee3eaa8fbff3932b0039e3ab7362723aaedffb759c9c39cb09157029fe5fddf0f56e84797e48f90fe079ec8e1e9
,980,124569,162476251,0,1579,32162476251,32000000000,0xef1a0c4f9608d99cc17a63409e322439516198b1,0xabab6350d171f033cd4751ad36b70206a5ff0ff024fda69735fb29e8e17e5c54641f98b8e05afb1dd20d75e370a09ab6
507,981,124792,162438643,6,2604,32162438643,32000000000,0x119dc5e7136c0e4bb1c99b009f645d2b5056b44b,0xb4c9da031a752fba2a9f15b9e3a56c40eaaef83529561237500e4c448a07146574291128e09e286280632ef8c8021cc2
,982,124715,162363954,2,2280,32162363954,32000000000,0x27a820b66356350bdf20dbde380c53b3bfda28ee,0x88ba00e3e643d02d3a39f4f72cc633e9f3b31b5ee235e0e375ac138d185221214d9b26314869707591ea8242349a2b21
508,983,123098,162343350,3,0,32169998623,32007655273,0xa1005c2f57b6a22b56b1b76bff4f67d7468ba035,0x88c7d4ad279cc03ceb0ea782a0830b69ef9be7e7bd5198637ed9ffe2b649128996eb5437c753f41f1eb292df7f0a284d
509,984,123102,162147936,3,0,32169725531,32007577595,0x0617bd4b2c0ce23b64fbeeb676d75d04b3ada87e,0x80984c44576c7b847efd7b1b0dd1edbc4fa8e7faa5839fa94db3b8f0ad5b862ee5e8ec146732267c576caa130cb6662e
,985,124681,161909942,0,1967,32161909942,32000000000,0xd974c75f228390090080801675b258c043032a46,0xa577fb3523e9791edb851dc2706f7f40055495f9bdab54c9d6f21f3399e6d472d0e6eb75d159f6e91385e8ed3bfa43e9
510,986,123096,161401922,1,0,32168915211,32007513289,0x0b36ea414dd859d0edb24bea04b3d5b17ba19338,0xa8f854c376267465cada054239d935e5b58143cc89a721de30aec1fd5e5342856887404e3e5e9c50830842b2475823dd
,987,124010,160993036,2,44,32160993036,32000000000,0x336e5ddb7215ff68b32a07a5e10995ce653a111e,0x8c21801012bdbb5bec5cfbe91d5ad5cc74c63c139c234d8cee8225865b63e83f8f2e74bf1c49996a926aaf28d25ab83a
511,988,123109,160929914,4,0,32168397288,32007467374,0xc7dfb2ff8073be2008c734bc542556c5d7515d0e,0xa8114ea24675291009ad8ab641a254d5fb219607cd4ad593312d28a87b91aabdc3191df50a859c062a8f5e315e4d378f
,989,124676,160647360,0,1966,32160647360,32000000000,0x724e42e83c36f5e23102fa8ec6352b6b121b8777,0x93af6cc902d56190ed8c4182b41695e96045e6ddf2fcf893308fa58e43e02b8111b55532bab689b222fc7120cd1fe2d2
,990,124089,160417035,4,175,32160417035,32000000000,0x8d8b9d2e5577ad98d7e57ce866418756151b6301,0x871d97481c5642686370733a60ff20c6259cd211552b9191526258dfafb1c7a452313a6a5e3937fd742376beb98be8e0
,991,124064,160075298,3,169,32160075298,32000000000,0x8d8b9d2e5577ad98d7e57ce866418756151b6301,0x8a31deb6c6ea4ff112b05342720524cc0680590314cffce4a84198765f4c8c5bf347c0a98f46569c6ef5b6cb95cbba1c
512,992,124711,160032524,1,2158,32160032524,32000000000,0x2aa364bd6ebaf6f97363b0357a0923c0f548c2d1,0x82a615e1f5ead99f4f4e4f9eeceaf9e83f2b403d811ccb56b837878d3f3bfb541f9d7d0bdd27f511a4481f351af63903
,993,124160,159874288,6,423,32159874288,32000000000,0x336e5ddb7215ff68b32a07a5e10995ce653a111e,0xb874053127223425f1e9f9e80e162ae63f3f6a64ef90ed266a34ce743b2a20dd60c981daf97b8e7a08487ea444514443
513,994,123107,159737075,3,0,32167233130,32007496055,0x2b5b1738e7fa2a0cb655591d4e8db58f59ba1e96,0xa7f42c4d03a56edee9989e55a5ce7c0ef2e2669c6dcd0a2779171751f39d9ee4bd13ab4998730c8b8e02072b7c9d273a
,995,124663,158419979,4,1962,32158419979,32000000000,0x75c8c9e5c64e9830814446d3b20b71ce3d19a21e,0xa846e2021281e40ed13f2728f184c6de195e3c75ff0a03ef1fb2f6257e00fd5ec1971f7898a2d8e19b94bd1f73816e59
514,996,124096,157402660,2,228,32157402660,32000000000,0xc45dfd2ba4d2ce8ab24a9334513bc56858a27017,0xa4ee36cdc66b53ffd85cc52bb49998e1b7e611f1208471ad3931d5fddd724444e20e8a09c9c1f5604789e7183545ce93
,997,124690,157336988,0,2090,32157336988,32000000000,0x92f67205dd7eea79972edb01beb895bb5abbe97c,0xab42bed062ddc6e698314d3b9c56196022f951f392b353b1d740292d4b2d699597fb76a90bedc6d48f3973674776a582
,998,124664,156638911,4,1963,32156638911,32000000000,0x75c8c9e5c64e9830814446d3b20b71ce3d19a21e,0x9075fd08a2f0ed90379ebef9649ebecc2a807fc622767f3737514007df27b2b8bbe235fcaaa5a905cc16adeb08451ae5
515,999,124015,155552387,0,45,32155552387,32000000000,0x73860a0340b1fff9e95d035cf35da774e79435a3,0x8f7d7085f589d7324046d4b5c0018ae50e143a954ee12cd97cde63e090017bddf907d3dc7f812cc909f83628dde04abd
,1000,124747,155221769,6,2350,32155221769,32000000000,0x8d6b61de69358cca25fef4b7f583bf3ca95a373f,0xb45514e9883c9f30c8cb2f1f9ba6c2c46acb7d7fb1e2969247e5b204f3c011b90c64af0b997b6b9f0ce5740328dc44df
516,1001,124707,155123057,4,2157,32155123057,32000000000,0xa7ed85c492f8b2b47521043337095ed048330423,0x96a97b9366960e3c17b585b775476440187aeef3501c84dc554e8f6880b8fd4070b8613d14b58c29fcead1f04724d234
517,1002,123095,154655024,3,0,32162252712,32007597688,0x706aa9b3bd8773068e346ea2d04ea0c59a84c45a,0xa1634881f67c835ec471d7449011119348eeccc5c015ad9b0d2d71f471ebae3be220e362e2182be2a53c44ed3f998dc1
,1003,124714,154385345,0,2280,32154385345,32000000000,0xe13037ea3f3978f401b5cca0ca775341a0fc1d05,0xb6ec303f75fe73e4b5a11dda96a492427d1161d8c8dc24a8abe092fe302569f987f164f495b81f41aa483608f5267ea6
,1004,124768,154245558,2,2475,32154245558,32000000000,0xc7ffc28142ec9cb93d1492ed2b8057d0f2b12fee,0x90e79a10aebca259c0fe78b17bdabc1685cb8afeb6c724f76c3b6cb6c961100bcb46c0572dec256254af6992659c1dd2
518,1005,124756,154180459,3,2352,32154180459,32000000000,0xc073ab237040f567aa0b479844b17311282198e6,0xa39c97f3585f37d300b44d06161ddc3ee466e24478ee335fe8c540a602c80118ef7a1c2f52d6758570a17d6040cf89e2
,1006,124669,153983880,4,1964,32153983880,32000000000,0x75c8c9e5c64e9830814446d3b20b71ce3d19a21e,0xa362640a35a5a75b81ebf015be314f820b42a4317aaa692b7395d856a8093b17a55974f14e0c5f54355f94daecd55715
519,1007,124643,153608013,2,1898,32153608013,32000000000,0xc872234c4abe689a941aabe8362d185d83ead254,0xa586ae8fe505e3d09d4c7f4ea68b57eceb16db50dd8568d6983f48504c48082da9dcd61a12ec20ec60316f9bc9a548fc
,1008,124716,153378816,0,2281,32153378816,32000000000,0x27a820b66356350bdf20dbde380c53b3bfda28ee,0xb015ae731fde0b3cd043ad9603368ee40068c27ddc03d7bd23e5791f97cb29d767f950f126009946196e47fbcef48127
,1009,124665,152618520,4,1963,32152618520,32000000000,0x75c8c9e5c64e9830814446d3b20b71ce3d19a21e,0x8fa0b39503455d00d9a2a49fe77edc311c92841242c39c0eec5e726ae3a3e342cd80fbb4cf2dfaac4cd749ed4cf280d0
,1010,124556,152498146,0,1385,32152498146,32000000000,0xc872234c4abe689a941aabe8362d185d83ead254,0x8bf76be7686b6174580f7db6446334511facbdb1dbe162c47bfa1961fe7bf6173047192ce931f75a1d27b5080145100f
,1011,124703,152496370,2,2156,32152496370,32000000000,0xcb64923781ee85e71b85ae5953f30abcc22b87cc,0x8c3fb8cd9ffa1ca5acd5a5b9d3e9ac15ceca2603c7a6e5a2f1c1e9eb00163c64149db6c17cea1ee85faa36aac439884a
,1012,124667,152184445,2,1963,32152184445,32000000000,0x75c8c9e5c64e9830814446d3b20b71ce3d19a21e,0x88b5caf953c28ca3acf6ee90133ddccbb39e275f6450fd58fa62698b9f22f385dec1943a4f496863bd2c3aea412828b2
,1013,124666,151879451,2,1963,32151879451,32000000000,0x75c8c9e5c64e9830814446d3b20b71ce3d19a21e,0xb85f3fd9a6263937f9bb1ec8f1a8249f8ce6eb072e832500ef122df87f22c25a2b7c8437cfb140a24412a3e0acffac05
520,1014,123103,151420621,1,0,32159101543,32007680922,0xae8f726801ee4a38de2a2626a53fe258f07996ed,0xb5b69cd195358ff8fac73735476c6a66163d0e0391cabff8d5b3cd59d4e86f212825d240d4c159694e66904653ca1d94
,1015,124886,151050289,11,3244,32151050289,32000000000,0xdf94c5c09514e01641fa73d03e3b927ce62bd93d,0xb3b1a66558d85c1b96e6d59461f8a64dfb9052b545578ea3c146e9e987e74db0cc7083e9c3f907142af6230613f7e238
521,1016,124687,151007442,0,2089,32151007442,32000000000,0x99aa06bd09518b433a324bd4da73665fe8571343,0xaa5a168a22e564aeab6610af98a51bbfcbd29be606e1ba6b9843379d63be261e658cb8840a47654a1ff6ad5af4217691
522,1017,124574,150946866,2,1580,32150946866,32000000000,0x384e3f7341a5d5e90c9b5a72b6e5e8e09aadc6a9,0xb779db24db1665a5d7952ab1bd64eca3458955b109f72e794eb6a335a9494d69e8e402717dd83aa9faa83b2508bb6fc0
,1018,124819,150837697,4,2734,32150837697,32000000000,0x7ff8519a897e47f7cbb528da420115535a76c0a7,0xb2d0aae5713269219a374b3ef01acdc8f715568526a44c5045f57d36fa6b66f5a726163cc52e85c2de43014b37ad6881
,1019,124573,150704606,2,1580,32150704606,32000000000,0x384e3f7341a5d5e90c9b5a72b6e5e8e09aadc6a9,0x817fa92fea45d87a368c578211b98a95ad0f64b1eec700a27dc446d36e159644c89a0a067b3b220c572c91db9edbc421
,1020,124158,150580670,2,422,32150580670,32000000000,0x336e5ddb7215ff68b32a07a5e10995ce653a111e,0xa56b959d3887ead44fc78f7f77f58d50d07e5bc5178134b9b9d8aa48b8c0eed0cff1319a53de760d8c1db7d9147af22b
,1021,124808,150574585,8,2731,32150574585,32000000000,0x7ff8519a897e47f7cbb528da420115535a76c0a7,0x87c02707b613053a088916ff728c9eea52d84613b65435dd2cb460376a72cffd62f705130a8bf03f6957650af162d09c
523,1022,123110,150054957,0,0,32157621415,32007566458,0xf41b9da1426f2323497324c56e61b8a7a9cbab8d,0x80fdc5fb16514294ef7fbb0b0378098da8c67230d105be76ace1385260d3d8516194eba44f6d76f60ebe1641b2efb318
,1023,124746,149740406,2,2350,32149740406,32000000000,0x8d6b61de69358cca25fef4b7f583bf3ca95a373f,0x81aee484f60a73b52a6d9f2a03e05cc3e188eb4f7a52b9ad80bc21ebbafb7967e06fb7a824c0fd58f3e94a3396fb2c4d
,1024,124662,149448417,1,1962,32149448417,32000000000,0x75c8c9e5c64e9830814446d3b20b71ce3d19a21e,0xa2fa25663a2ccfec03546e6f59d5605faf1319ce8d81c56dcf60183c863dbbac34fb40e163f8a337eaa16be07c6ac847
,1025,124668,149366654,2,1964,32149366654,32000000000,0x75c8c9e5c64e9830814446d3b20b71ce3d19a21e,0x8d52a567afdc3b1e537c745fdb6fcb12b293a7b9985d2bfef704c24a9a4b4148ad36140f0ae806e01835cf10a3d39190
524,1026,123052,149352811,1,0,32157181683,32007828872,0xd4d4161c83fc519c7b34d111b6c9772eea6608b3,0xad960bd17cc4e7f0082cb53ae21b94b6d147df25530a3941aa529450f3a6b55727029d320528352bd43cf646a5e357fe
,1027,124373,149212671,5,1008,32149212671,32000000000,0x74a5011587240ffeba5740dc06e0bc1cb3314049,0xa9a08f24ca522d86f1a741f0b890f53a6d7439bef390662f2468b352dbed5745da1b620a4e4ddca7873adb6346d499dd
525,1028,123108,149109834,1,0,32156664986,32007555152,0x8779c4c60c0b4201351c073eebd490cd2238e582,0xa3c8a71bafd1d061dfe1d8181ce196a961c61a99206c657c7d10ce09db5499e2bc696a639f87b8bbb890a899f03871eb
526,1029,123101,148985758,0,0,32156387366,32007401608,0x604514d620b9061d19ca6f35ff7cdf8c9fd58a4e,0xb5821ec6bdeddd363d65a332a0d62a6c8e7252e1c1e0858dba03e29831fb8c88d499d926b316c2e51f07a099037e1710
,1030,124767,148926321,0,2475,32148926321,32000000000,0xc7ffc28142ec9cb93d1492ed2b8057d0f2b12fee,0xa9f8329a67b7b95a98d6115c210495eb1234ea268633d27234e052f61eb63806cb68f6532351d898256170a2ef20825e
,1031,124755,148837838,0,2352,32148837838,32000000000,0xc073ab237040f567aa0b479844b17311282198e6,0x98af0a586f2ea1b5807c07cf0964d97728b4f7ff27ab42f98ebac5b07329851c549c9e452cab2fa3c1dc1f356d94b825
,1032,124683,148705662,2,2088,32148705662,32000000000,0x5f375046a8eafd746a2482a31c5587116ee810ab,0x88a36be9b5b1dd084cd1001bf6f0a91f6e75bc88674f1fdcbaf4eed14b7aa2aba3b2535c24337cca70b790bd7d4ba36e
527,1033,123100,148606515,0,0,32156150794,32007544279,0x9217091ba1927e061102565b6a957b0317265059,0x8c5eacd43e1f6f1c61df20c4969e781a1aa4ce1eb7f1d4ad0ad341ef4424d140e325a74501fe2c21cb0f663e45476356
528,1034,123106,148160097,0,0,32155758462,32007598365,0x6512ff8ef532c91be4ff45275bba3b5e81d0e266,0xa3d37a8e7863d2d43b46b07118e906454697b6b216d63a44f49975690bb215086169831a67401a80e483a2847e0b9d4a
,1035,124159,147932577,3,423,32147932577,32000000000,0x336e5ddb7215ff68b32a07a5e10995ce653a111e,0x8b483ef0a493c34fc4849e9f13b984f47ed40f90a4616110a7204d4da8bff8ac38c47bce3bd5ce87b12086a1d65500a6
,1036,124793,147749508,2,2605,32147749508,32000000000,0x119dc5e7136c0e4bb1c99b009f645d2b5056b44b,0xa5d1253fb8a9c32db20cf5828d2e8ee8f33dde45651be0563368b64ba01b1db047c8abb0a330b503753786b61474bf25
,1037,124818,147420873,5,2733,32147420873,32000000000,0x7ff8519a897e47f7cbb528da420115535a76c0a7,0x93f74ea889b381f310cee02ab81bbabb9327745aa136720d25ea85384fb78f6a2b9560c38e23f5e04f11a91a76f6ed1e
529,1038,124846,147091650,8,2859,32147091650,32000000000,0x3668ae02881c9e94054e7c8c0ee54e70a2f5482c,0xaed80e91236a5bc0a8c38ddbc37de05c28175d7d883ca5bc15f29f13a09f2285ea81e44b67924aea3d32fbf934a4e84a
530,1039,124817,146855974,3,2733,32146855974,32000000000,0x6203a91ebb17ea3b61818ce901d77e51e17e473c,0xb219857d9ae3fd3abc71e24c9ebb829bb838bf316db6b4d192db760eb1c1a0e416a443550fd2a63c37124ce03d5dc73a
,1040,124661,146653083,0,1962,32146653083,32000000000,0x75c8c9e5c64e9830814446d3b20b71ce3d19a21e,0x99595c80b295fb02d20a6b104cd59ab17794c0635d100fb3ce1af098e787163d782ac9187bc79b9c1e92afdd502e80a2
,1041,124670,146327274,0,1964,32146327274,32000000000,0x75c8c9e5c64e9830814446d3b20b71ce3d19a21e,0x94860492109093f2a8957e181aa601b37864bf26f1adb06557d6a2f57c3179f48e0bee2909ac1a5bd859a58c08cbbfb1
531,1042,123355,146177736,3,0,32151542219,32005364483,0x06d5efc3712d206980355cb6999cf33c350faf5c,0xb812468745524212436acc293fa0945c6db91b3c32b1f5ea59e82178e1b08444a6f900f2f5dce2afd854f78ec85c5971
,1043,124887,146106325,6,3245,32146106325,32000000000,0xdf94c5c09514e01641fa73d03e3b927ce62bd93d,0x8eea40053548fef44693efc08deb8e8aaa453d02364b5c89ead1c8453c48504b661211d368caf779b9b37ba0674a20c5
,1044,123056,145098932,0,0,32152295699,32007196767,0xd4d4161c83fc519c7b34d111b6c9772eea6608b3,0x941500b2d1fdee253608f8692b07fd205ee9b4d476fa6bf8077ae61a2f9c2d435d14dcc8a4c3e604229e4358fc69c0f9
,1045,124157,144940051,1,422,32144940051,32000000000,0x336e5ddb7215ff68b32a07a5e10995ce653a111e,0xb0df98ee89777e3d28f3cb0a3ddb00e6d731ab0b3d1deec97666cbdfcf4db90d41408190c1ae272990ecd1a17221ff48
532,1046,123911,144355041,2,0,32146129544,32001774503,0x6bb42be5bcfb866170e35dac9c5135940d951797,0xb6c16410699761a3fa90d7d23f475647733be7a937bbbd263fd57d9714c2b78c88a1a67f491a014e78896c904b89205d
,1047,124712,144289466,0,2280,32144289466,32000000000,0x75c8c9e5c64e9830814446d3b20b71ce3d19a21e,0xace7e44e3b4eb43486cb6898291eec3855afb423ac5f365e1815497f05becc7c5934f290fac081f1b20cf5bb3a8562f8
,1048,124810,144233212,2,2731,32144233212,32000000000,0x7ff8519a897e47f7cbb528da420115535a76c0a7,0x96fa409cebde2d831a621a52205462fae5a6f07db1d2e30364ed5bdb4185007c8fe9eb8c36f150a5be63641f8c9e3045
,1049,124813,144034367,6,2732,32144034367,32000000000,0x7ff8519a897e47f7cbb528da420115535a76c0a7,0x95cd9c84614442f50896b645338e94e3d71b1d691e442fc8585c86b3243adac6ff457caceb242535b52eeabf09f8025b
,1050,124801,143907952,0,2607,32143907952,32000000000,0x724e42e83c36f5e23102fa8ec6352b6b121b8777,0x835f7bacffab078742219c1ef92d2b22e7068cde8e24df9a55dd54d24d4ab270b3f5adeddb461749c58c75ddef270228
533,1051,123099,143038952,0,0,32150630555,32007591603,0xdb0e833bbba3afc441428520478f1182e66cd781,0x8da87db518fed3cfb24034c252bbe3ee7891691974d10f997f50be335ff0d7c16b7218ffb267a80618610cd1e3eb4ac4
,1052,124844,142485109,2,2858,32142485109,32000000000,0xc073ab237040f567aa0b479844b17311282198e6,0x91fe3b9e169a2d7fd5c42807803b1591caef7ac17e51e416c96fb891c79bf4e7679c6d4c574ff882780ce6d50a0e75ec
,1053,124816,142055276,3,2733,32142055276,32000000000,0x7ff8519a897e47f7cbb528da420115535a76c0a7,0x823886c8d3c05e1f36bf7d74031100890d4bb855272d8d8bf4124446884820ca9535a63792b3348d25e5e7553ed7c674
,1054,124575,142047155,2,1581,32142047155,32000000000,0x6cfa9e52be1f4a3b473f54978a886aa7d06df936,0x90e3edad83204fee64e03b83f7cf0cf3c82ab235494bd92ec25b11b49ff08a5277c90efec1c8a4532eaf5e398c8e5b40
,1055,124812,141955861,2,2732,32141955861,32000000000,0x7ff8519a897e47f7cbb528da420115535a76c0a7,0xa6591620a9c64524b52d964ba994c0e1837e1d0cc8fb7ab8af11d7c5500d43259852c651840479dcd96cb9eda88447ac
,1056,123581,141664707,1,0,32146799378,32005134671,0x6bb42be5bcfb866170e35dac9c5135940d951797,0xac26db020434b5fe05d38096963b21843b15d267d4ac32dbe2f1b73dd55f76576aa99acd44f1f3b5d7a0c8fb23767a3e
534,1057,123704,141604339,3,0,32138724756,31997120417,0x8605276e1d521d40a8ab93dc1ea620cbb8c75273,0xaa5312ee96687b2c61c993ec7b3e9ef5ace5568ce4a2962c295aef3a19e802706628817f0f673ef1a2370b1c97485e15
535,1058,124849,141259413,4,2860,32141259413,32000000000,0xf3e834ef21ee3897d775a23de53513f1c9d6a2dd,0x89cca54d0962e698d15ecae9be6d4930028cd3d9322bbabeac42ccf3cbd0f9b5ff3097b91b0089c7b8984c126ecbb809
536,1059,124742,141080017,4,2349,32141080017,32000000000,0x2e9fbcc162b225def22efa54c032a32f7a87f933,0xa50e8e8bf494d37401a77f4f380f1ae866b50b498263ea7376ad5ecd0944bcd14e44e4743decb78ecb32f9d66d70d31c
,1060,124811,140884323,2,2732,32140884323,32000000000,0x7ff8519a897e47f7cbb528da420115535a76c0a7,0x8436ab9e805fc20a0aef5e1dea72ce3b1748b84219addba01927c7962190e959136f263d9e52f1910b2a757ec549db6b
537,1061,124832,140730619,0,2737,32140730619,32000000000,0x18569525e58d508eb186dc68328a8ef18e627fd0,0x8ab07f3d275a1c8cd97c7b95350fae649f14b21e55260776ad24f1404885f284ec02110d3bb1974e8d994ba10b161534
,1062,124374,140315181,0,1008,32140315181,32000000000,0x74a5011587240ffeba5740dc06e0bc1cb3314049,0xb49de9552b56aca0d56d84435bd0c952b3b1c52aac7425e1a2bb9c4881fae94af60578c800da5f2ed2a91e4f1b872270
,1063,124135,140008378,2,357,32140008378,32000000000,0x6fe09034941ac88126f416098b45917a0c9e3906,0xabebdac1c5e98539db6bf4e7e73f6edfdcdc27b4ec7a11b00591f188644def93d409106c4d0a72b09b20366ea199c15d
,1064,124136,139996089,1,357,32139996089,32000000000,0x6fe09034941ac88126f416098b45917a0c9e3906,0x81ed67eef554ce48a268b5d51f7cc59f9326cc575b82e456733f2284b39fc315590e8c1ff25c713bddfcf3ed05019938
,1065,124835,139291201,3,2738,32139291201,32000000000,0xfd804e940951f1a204b1c41d3cff450bbbef69c6,0xb3327408bcc4d0102e6d612e40241a39d1f5282cc2cd28a7a9b3e090d05e67033ff0e0ef7e9fd853d1bdb7e30b659a08
,1066,124951,139107430,7,3510,32139107430,32000000000,0x724e42e83c36f5e23102fa8ec6352b6b121b8777,0x8ac7323f3d6d94cb4e96920c1b00c508a7d496853d0e11aca327407769b4d1b815a1fea4fb32c911176cf192dacef582
,1067,124845,138536050,2,2859,32138536050,32000000000,0x3668ae02881c9e94054e7c8c0ee54e70a2f5482c,0xb89e2ba183faf89b298443e57e2db48931aba478a46c9de2e306ee7ab10af910b60ef237b101f1a79c0117b4c3fe01e2
538,1068,123955,138520113,1,0,32139929296,32001409183,0x24d5ec8eddb8ad36cf0d20422018f879d9a56b67,0xb0ad1376262122dd1bbc7a178b77effa42347a54d74a6b59798a70c96d8607f644728b40538b812e627a25b32db1084a
,1069,124814,138502390,0,2732,32138502390,32000000000,0x7ff8519a897e47f7cbb528da420115535a76c0a7,0xb238cf5145deca32c527241ca5d61656b537d891790f1349fbb1d7bf87e737fc621a828e1e0d7f74db5d00a2f5d04d1b
,1070,124815,138168352,0,2733,32138168352,32000000000,0x7ff8519a897e47f7cbb528da420115535a76c0a7,0x8bdcfc093c850806f397ddbe7525aed5d6bdb7821cd2ae506fcdfcf62311b01bdee5bfc69734e33007690f5ceb2e49bb
539,1071,123938,137718988,4,0,32142350279,32004631291,0xe2a2d744a2701da8afab16e5d2c47f612ec8c240,0x830627f7365d790bb47b19af722a90919fc688c9bd13921851c6198339e56f2f9d4be506afd515cfdd8c6feebce6c811
,1072,124576,136267058,0,1581,32136267058,32000000000,0x6cfa9e52be1f4a3b473f54978a886aa7d06df936,0xb4a068da5c01a289f7ec8c7f66242870bde8ffb48fe846ffb5d71fcc70dfc76e524fea978883d8eec785f557a8fa324f
,1073,124930,135910536,7,3505,32135910536,32000000000,0x724e42e83c36f5e23102fa8ec6352b6b121b8777,0xa894b3bbbc5b3a964050400da4926dabc57b8300be48e363a80883e12a3af6de0c9124dceb0e1fc85a7cc21f07aa88c2
540,1074,124053,134898782,2,166,32134898782,32000000000,0xb921c44296390cf546d4c60e34832cbb55a85d07,0x80c73f27e19c96f43e4473c5692b0ca57be9f54ba33d6e0abe5a6cf0c5b477338300034cb6926de88a15d7997f40b938
,1075,123702,134839494,0,0,32131775814,31996936320,0x8605276e1d521d40a8ab93dc1ea620cbb8c75273,0x8d44cb74064f3d5a4c35a595df85f3513d8eb4ddf884e7e1e79c44b3505b65511bc7b15504c13390c11652a1befb2325
,1076,124936,134792640,7,3507,32134792640,32000000000,0x58020046d1dfeb7172709be7b24aed84b2c1d788,0x8f07ec510b3aecd0f824670416893ac32c646dc0a7f508f4f0779b060166b766de5620e552b3d080a225f81e62e9bb66
541,1077,123914,134756551,1,0,32136503088,32001746537,0x0c3c71f9a8eb1720aa2ac8f7fb1bc004c0d2bbe8,0x93d454a5c5246b599743e63487ba0759594a5029c2055fb029248a7c5ea3fed04112b9524c3f042c210cd0c600b64a8b
,1078,124874,133750980,2,3115,32133750980,32000000000,0x5f1b1e2d4b10dd77e441240dd8a6a17dfff70f06,0x86863b2caae1e7cfc2f5950e3a9dde02d73ffb87090d23946fd369476136d8f3afc100f50575e1f29795d0e28f8a906b
542,1079,124985,133051459,6,3751,32133051459,32000000000,0x7c01a6f6c2fabe80631db4b546191c864e19e35c,0x800a2f661dbda6cd7d0e4a29f4e0892eb51a96e8dc7935c7c205bdd7f4dafd2c34f99c84b9d215b84ac9b9dd2e029d36
,1080,124972,132863612,6,3565,32132863612,32000000000,0x9af8c16a29af0b8a7caf139b1e5e14c387579742,0xa44e1082681ea1be899160457fdc6080f7d20a73d85d544441e3e664413720565162b2d81f1665318e1032e8a42f03d6
,1081,124052,132727603,1,166,32132727603,32000000000,0xb921c44296390cf546d4c60e34832cbb55a85d07,0xa83372278e1e1a3f7ec24380c0fa36d15ef936917abbfd626481cc79ea788acd0bf11b8f406cf3640cb136fb1fe36a0e
,1082,123703,132527913,1,0,32136883546,32004355633,0xe2a2d744a2701da8afab16e5d2c47f612ec8c240,0x8981ad337d9e977494a11a23f34ff2a1f1c8ed63aded7d8913e6e76b24adcf21208c01afa94f29c91811dca5ed1059c8
,1083,124894,132432701,4,3246,32132432701,32000000000,0xb38db4853325b92b3f21e553f327169a91fd64e0,0xb052b205420230c31491a52f95bfe2faadb03666673337b9fc77365645410ecae71991aca663e7353d4139b00e592915
,1084,124950,132281069,6,3510,32132281069,32000000000,0x724e42e83c36f5e23102fa8ec6352b6b121b8777,0xa6b043ce057069295ec205497bbd5ec27bc0f65be8b6e6da268c371dbd26e46bfc94394de1728e265c13568f1c1cb05a
,1085,124918,132062368,4,3502,32132062368,32000000000,0x724e42e83c36f5e23102fa8ec6352b6b121b8777,0x9678995d2af3e080232a8860c69d9755ab3fba21f5e2ba3fd9bcb92d920003f79dfdc582ccf5589dc0624d60d90826c0
,1086,124895,131926224,4,3247,32131926224,32000000000,0x3668ae02881c9e94054e7c8c0ee54e70a2f5482c,0xa865c2297e0f110c4b13ff47cf90bd28dd898b38d1d2f5d10a47e9ed3a60c1286edadaed7a8e447d00769ec3d7e1bfad
,1087,124890,131752533,2,3245,32131752533,32000000000,0x3668ae02881c9e94054e7c8c0ee54e70a2f5482c,0x8587f8a39149a767a0bc8e8aa317bb30fbce8d449e74fcc7bcfe2e45b97d495ca7ce3738cfae7157f1c6132bd91f982c
,1088,124979,131450911,7,3686,32131450911,32000000000,0x724e42e83c36f5e23102fa8ec6352b6b121b8777,0x878901dc837dd6dffa78f10e7382fc2255ba64eac8fa6bab643750f9967ccf2f4d8a7ceef758ab64c6403942bc9772cd
,1089,124889,131435987,2,3245,32131435987,32000000000,0x3668ae02881c9e94054e7c8c0ee54e70a2f5482c,0x95d7e3070e655062d4a6b2af506932602d7519a8da1c566dad63e75382db4c7ab5e867fd83a03c310e639859730a47c7
543,1090,124603,131322362,2,1705,32131322362,32000000000,0xed23e0c712f60cedf42aa65855610fd926d9affa,0x90e15555796c1a629ae6cf6396e8792b8e1f03923e0891d61441a027d22d9ff7ce9fde6ee34223e270e6ed5def309e74
,1091,123913,131265866,0,0,32132941432,32001675566,0x0c3c71f9a8eb1720aa2ac8f7fb1bc004c0d2bbe8,0x96b0f4a43dde5867a78de6b420e81554d46e6809c75a694bb59cb048be65b83e3cdbd559fb973bfc574a006842977059
,1092,123954,131099587,0,0,32132551953,32001452366,0x24d5ec8eddb8ad36cf0d20422018f879d9a56b67,0xa4d8f98ce8f24a5a31be390b81bd05671af36832ba6d6cf27e71840ede4bb3837d1350ddea2078d0c3ea65cba7457629
544,1093,124743,131076583,4,2349,32131076583,32000000000,0x2b07b3a2ef775bb5a5b3c0d42caed2cf8168e53b,0xa12bd43d3c783439d5739c51163b4497fec2c72c48c5121fbfd87244ecf75f3de9ee1deddafa154018f922b8c2c21f83
545,1094,124834,131070174,2,2737,32131070174,32000000000,0x717b156adb2fec6bfe5c10653c44eb7dca477bf0,0x8bcfca61df246478bf50d68ef76008dd33c968fb567c53cd5b08ae97b8b4a0eb4d3e6237cd1fced8220cc3f93e116008
,1095,124943,129399629,4,3508,32129399629,32000000000,0x724e42e83c36f5e23102fa8ec6352b6b121b8777,0xa256c19226b706c0af8e597ea331c346375328524d4fb28603f4c250c110c2f9ecd4d539f3c8a7732610e5a5493d9131
546,1096,124331,129118456,5,938,32129118456,32000000000,0xab6ed86c67439ed59c7841a66ae1d3aacd658dca,0xaa28151172369f5d2fdd0dd66c3968e991528303a9139fcd0895d908d7214d327d7bae051d0aeda0712d67df175af7c1
,1097,124958,129074606,3,3512,32129074606,32000000000,0x58020046d1dfeb7172709be7b24aed84b2c1d788,0x8d2fcce70f5693bfad2268c254458d051caee8ebb8d063d0ab8533c9f2a151b8437674effb5567f020dc2e6c62bbbeae
,1098,124366,128942949,4,1006,32128942949,32000000000,0xd4d4161c83fc519c7b34d111b6c9772eea6608b3,0xb870bf53e90645bd877d49a6aa4eb2264767baed5feaab79ddc59f0e986884b28a1ff331c0719d7c21b4265e6ef02f4a
,1099,124928,128515137,2,3505,32128515137,32000000000,0x724e42e83c36f5e23102fa8ec6352b6b121b8777,0x8a40cd77e3366645f3035bd438f76d40f4e1c8f3e926e06d24103631e9e313d04dc25aeeda5d5612ecd31b555cf12d88
,1100,124942,127177740,2,3508,32127177740,32000000000,0x724e42e83c36f5e23102fa8ec6352b6b121b8777,0x8347b7c9c7598fc5859e90d6a185799e67bf1cd7b0536aab6a7ffdf4c39b94481ab03a7685523b3b6adb2bbf575be3f7
,1101,124929,127004015,4,3505,32127004015,32000000000,0x724e42e83c36f5e23102fa8ec6352b6b121b8777,0xb4d03a032f637a43ed8c4a50e25312d5d8aac41d1d092560dc9fa60a38350680ffcc183538502263f934a1f5cd277d2a
,1102,124916,126848209,2,3502,32126848209,32000000000,0x724e42e83c36f5e23102fa8ec6352b6b121b8777,0xb7324c245d493680fa96b7e2ba616ec71a57df372f63ef8f30d4d4da17abeb99125cc0103e29532112233e0d1a479ed4
,1103,125004,126770691,5,3817,32126770691,32000000000,0xc7ffc28142ec9cb93d1492ed2b8057d0f2b12fee,0x827ea4ef05777db67c5aac330d1dc02a0fc2985666b703eece6b486eb760eb0e17e0b0dcc7740e787d2a4ebab14c205c
,1104,124893,126657434,2,3246,32126657434,32000000000,0xb38db4853325b92b3f21e553f327169a91fd64e0,0xb5f1cacd818c915b236dcedf0be13f993f8a3d884a1481fd7f5031ced2362965c28601fb47aae7fa87e5b8676e8fc219
,1105,124947,126170610,2,3509,32126170610,32000000000,0x3f6e64cabfc18106c3ca38bbd026180da1ef4969,0xa912b7a633a51920fc51deceaf6b906a2fa6e17e2f4b99503dd7c4d57b4653322b357a696edf33b12093a2281a604205
547,1106,124902,126081562,0,3370,32126081562,32000000000,0x51e726e2952fd94037c2ad4deade6d6e27ba041f,0xa7359469144197ab4b0d2c584d2ec5cc87a0a115932bd98b2c217a27cb6e776a141705d6d4ce5a3dc9edb5673f627dff
548,1107,124710,126077693,2,2157,32126077693,32000000000,0x7ad714f0a49a1317f2efb0c536d942f80d9596a4,0xb68d92b43834a5b21f3ae9d330ccfa1a990d55811354cca04196ca52220b20f1e6870c1971a15263387fb6d1f20fbd1b
,1108,124368,125931925,2,1007,32125931925,32000000000,0xd4d4161c83fc519c7b34d111b6c9772eea6608b3,0x82d99168c8ba2544f3927412f621115e36f30b841bc4aaaeb96e61384e1d9395e3205ab3b74279ab19fe1167fcf86238
,1109,124944,125911626,2,3509,32125911626,32000000000,0x58020046d1dfeb7172709be7b24aed84b2c1d788,0x8d825f5b8fc6f84917b550fd343e2494ce4f59f340cf21d5181728ac28a3a16584e1ff5c47b2877a770b44d77e698411
,1110,124888,125784060,0,3245,32125784060,32000000000,0x3668ae02881c9e94054e7c8c0ee54e70a2f5482c,0x95dbc7cc7778d73bc575c92a8ba3482f7a058698bf9223cbd1afa1d487fcaa31ca4fc16073f76bcda91dc5214dc3cc6b
,1111,124968,125758209,2,3564,32125758209,32000000000,0x9af8c16a29af0b8a7caf139b1e5e14c387579742,0xae2317c4ea66ccee809a07e6dc9cce14810cbc96b751040d933e52858169be1e826e6e19620bb004b1be1d0313df0ceb
,1112,124959,125655207,2,3512,32125655207,32000000000,0x58020046d1dfeb7172709be7b24aed84b2c1d788,0x9991f1f872641fc0c043f5276446d7a4d29276244cf395fb081d39b6db4a5a239ec7c892bc325df9c9c39da2e974c75c
549,1113,124346,125236255,2,941,32125236255,32000000000,0x11110a504c929dc8985760bfead0c78ca0d6d5a4,0x9063e522e118bd770f1aed9b1d9d86b1087cadd571a0eb420950c9447a4f273b7ea7523ed6ec6b476208b25a17a88810
,1114,124980,125136192,4,3687,32125136192,32000000000,0x724e42e83c36f5e23102fa8ec6352b6b121b8777,0x97374db709712488af324ef44dd19c9935f01044a03cb8bb260649bd141c0f5ca1a91a5a304a880634309da813d46e48
,1115,124957,125119634,2,3512,32125119634,32000000000,0x9af8c16a29af0b8a7caf139b1e5e14c387579742,0xa6a1e922ad981aea199450b3b1472b0ee5f491e8710191924658f81c6c40ef445109307d1b9230023d572df31f47d13a
,1116,124956,124908186,2,3512,32124908186,32000000000,0x9af8c16a29af0b8a7caf139b1e5e14c387579742,0x8357ac3f097d855a7598643fa9188de03c4671e8f9e0dfa9a91bdfd9e46e84effdd8ded1cde1864a850c556c1de8e9de
,1117,124955,124886961,2,3511,32124886961,32000000000,0x521deb0d352d70868a6c3952b3bd478f11eeffcb,0x8c1847cbd2a38e309bfaf79af8d114e896c75034c29bc2a6226db8349110f00e7de6cd8f23d2098c48b9093530611867
,1118,124738,124071287,2,2286,32124071287,32000000000,0x2b07b3a2ef775bb5a5b3c0d42caed2cf8168e53b,0x8d1329288700acac968bc7e066762781684d24938dcea6cc0c4d385787a1a5132ed7ffc251b87b5a8b721b68afe050e8
,1119,124925,124020972,2,3504,32124020972,32000000000,0x724e42e83c36f5e23102fa8ec6352b6b121b8777,0x95fdb544a94f4b34baa51e040b8114adea3232ce0a3e08e060c2d373b00f469e26e59f6aa003abc0de3c31df57dcad44
,1120,124969,123968408,2,3565,32123968408,32000000000,0x9af8c16a29af0b8a7caf139b1e5e14c387579742,0x9469be9d91f57cdd0a8f2fd0da232154186295d393661398e0245bec5edddb66e95fffff18eb2a158c99638e4efd75e2
,1121,124941,123910321,2,3508,32123910321,32000000000,0x724e42e83c36f5e23102fa8ec6352b6b121b8777,0x82a2f662f820229a4265e263b43515b3ed17d775daf3588fea91c29c073d4e23a1aa6f2adca47476a19a918edac8294d
,1122,124932,123843630,1,3506,32123843630,32000000000,0x724e42e83c36f5e23102fa8ec6352b6b121b8777,0xb4953b6886dd2a837fdd8a4095c5d5a8ebabb7a428346e81f633563975fa0c651965b85d38bf62031a9484f31fd414cf
,1123,124974,123780858,1,3566,32123780858,32000000000,0x9af8c16a29af0b8a7caf139b1e5e14c387579742,0xac5139de2e018e75286d5060745ed3cd24887da726b70ffc9bc8769a7c1743031bf290a9e3e307cfcd020d9534cc88e5
,1124,124971,123595491,2,3565,32123595491,32000000000,0x9af8c16a29af0b8a7caf139b1e5e14c387579742,0xa1daaeb21a3555f0174d90fa91dce7f1faf73d879dd4880e6d32652cbe2f7fb087471a5d7862352d71d350e8d4c94534
,1125,124973,123432583,2,3566,32123432583,32000000000,0x9af8c16a29af0b8a7caf139b1e5e14c387579742,0xabbef073ac20f679130e3ce5c6f68ee415a4886aef39dca3757185180726015e9dca2f5849024655b8467d2cbe1dd240
550,1126,124898,123252866,0,3307,32123252866,32000000000,0x9afee97984c8265585356c4cc52159d60d6a510f,0xb2001f76e1161e39fa8cb57d2fd5af328c409d93f8783538a432f69609e719fecdb048344037570115726a6df6fb23be
551,1127,124995,123209112,4,3753,32123209112,32000000000,0x1ad836014d9c2150b432ceeddd669d1d12a5d87c,0xad2d59366028dab9aaeba82bca392eb138f1cce2d33c66d86f23fdbad7cbfb224ea49cf0f081b448a3e0f5f94b388b9b
552,1128,124565,123025157,6,1447,32123025157,32000000000,0x90aaff6a8debd44c7736c23e1b26f42dc75f8d6c,0x834d17c2a45830366506e1b4c9b1d32fd73973c83ec2491d126cd8cacc345e5c02dc701bb76fa07ef75fed8e3d3a65ed
,1129,124332,123018438,2,938,32123018438,32000000000,0xab6ed86c67439ed59c7841a66ae1d3aacd658dca,0x8765862d30a6fc6e19d0529d7e8e025a0fc4033f5e14c19b4e9731a465495b079170a224885f91138b96cc4fc4d3735a
,1130,124940,122900948,0,3508,32122900948,32000000000,0x58020046d1dfeb7172709be7b24aed84b2c1d788,0x9417ef76562912bba3bb15dbdf9cdaf70f781ac1b35925148fbaca26750ef9af90ea626c9dfcbec3853d110115693203
,1131,124939,122596066,0,3507,32122596066,32000000000,0x58020046d1dfeb7172709be7b24aed84b2c1d788,0x9881024bc061fc2960556a9c1b625bb353e7dda499ba29390c3915d69530f32ca03ecd0c4ace42a8d7fec906c60117d3
,1132,124946,122550495,0,3509,32122550495,32000000000,0x3f6e64cabfc18106c3ca38bbd026180da1ef4969,0xa83892d4469b4c2fd8da1459c4bca83ebc39248cd0147f1630e5c52e85cce6e71fc8712a09a539368a5700aa0ea0b0c5
,1133,124899,122517720,0,3307,32122517720,32000000000,0x9afee97984c8265585356c4cc52159d60d6a510f,0xa163bc7a23115b26a2ad28eb30313d02f8163e6c331704a87880b1fe61b1a2be062b526eca5b01e7b080dc946bc3294a
,1134,124954,121821077,0,3511,32121821077,32000000000,0x521deb0d352d70868a6c3952b3bd478f11eeffcb,0x9264f0d82f0abccd08dd36e0af38497d95b83e3b73bb019ff6a2b6bcd69db1c6de7df31b959cdc153f176d4ccd537089
553,1135,123943,121391251,2,0,32120014824,31998623573,0x3f32ca52ac4316e6a5252b95388b59aed00b3402,0xa2693f8d10013587d4cbcc12b66b08c8034fadc90e062d65f673a5ec920951f07426192cafb8c31bdff3bc397af238b3
,1136,124923,121060619,0,3503,32121060619,32000000000,0x724e42e83c36f5e23102fa8ec6352b6b121b8777,0xa0fb3bad6fea765a9c5f01bab2ba8a3616157ca7f80ae4b7d9cd8e0bdff3b5a3fc9d62ff2e6e09612699de055dd02a7e
,1137,124921,121038818,0,3503,32121038818,32000000000,0x724e42e83c36f5e23102fa8ec6352b6b121b8777,0x9083c933c57d1e86c5b550eea9519c66e9f151e92ae632b684eeca78564cf1d3e2948577e6fb345b8e27402a56b2d9f8
,1138,125000,120713546,4,3816,32120713546,32000000000,0x1b8976ec8bc31aad9d1831e7ffb7a89e089e4e5a,0xb1556a3a1bf4f95c40f022f2958e704dfe7abcacf742781d4b16febff27a04333e50d91f9a78d17ce145356caf7c8a2a
,1139,124967,120492292,0,3564,32120492292,32000000000,0x9af8c16a29af0b8a7caf139b1e5e14c387579742,0xb990ee072c950ee1542c2cb92876846072002f737d605130598eff365f5c23b2cde958842f985bf3020a2c0b53668fa2
,1140,124975,120336302,0,3566,32120336302,32000000000,0x9af8c16a29af0b8a7caf139b1e5e14c387579742,0xab07bfaa9e91a233dc7015bf4a4c0e84716c715ecd759fff83acf4d982bc4847ae5049b3755e65c3131c5cd95acd37eb
,1141,124970,120177731,0,3565,32120177731,32000000000,0x9af8c16a29af0b8a7caf139b1e5e14c387579742,0x9143ec5a17eadd4ae3ddda17430674a27c958fa871de5e195e62d2ac68182800313abc2176a19985500d6b074797f0cd
,1142,124981,119105410,2,3687,32119105410,32000000000,0x724e42e83c36f5e23102fa8ec6352b6b121b8777,0x8fe1d7abb304502c4432e466056add94be93191b5b0d507dacba10759816c45adcf9932e63ef205c80d46b6052c3e2b9
,1143,124999,118935571,4,3816,32118935571,32000000000,0x724e42e83c36f5e23102fa8ec6352b6b121b8777,0xa8f40c7fb60e6caf078991bf3bb0b034d59223feee2fb8cb38827890d9f81379359701c8ff0731cd66b8c4b75925e41e
554,1144,124911,117195876,4,3500,32117195876,32000000000,0xd5a6388cd3c0a8b984bc64446bb408f76162cf1f,0xa5411f3f9515256897d7c4c9e6327e239764ecbf37551827e514af94601c2c75f471334d9d97fbdc341719a3aeef8b5d
,1145,124998,115900721,2,3816,32115900721,32000000000,0x724e42e83c36f5e23102fa8ec6352b6b121b8777,0x8315807ce868354e1f21a68b8e2a24b0479b92affc73a5dbc6a5ba5902f7319ff010e757157e124425756304bcd26c76
,1146,123944,115092322,0,0,32113740477,31998648155,0x3f32ca52ac4316e6a5252b95388b59aed00b3402,0xa4d2cff6299976fab8bd906177883708aff114de6bdb26f326f6bdc073b4d6c6cb165479d47ef5dc5e52f566326ce5f6
,1147,124632,114847900,0,1833,32114847900,32000000000,0x7ad714f0a49a1317f2efb0c536d942f80d9596a4,0xb71ab9f82b9dd38c710f705e4f7a3ac3122a6d4327de713361a679c9cd0193fbf8627c87b42a9dd5d744e46a338637e5
,1148,124996,114803515,2,3753,32114803515,32000000000,0x9afee97984c8265585356c4cc52159d60d6a510f,0xa490081129963d6d412c4e1eb9d6ab43037c9000d1947100952f1765522c1b2a5f453ef15cfdbcbd7ae6ee7d50f32447
,1149,125003,114582202,0,3817,32114582202,32000000000,0xc7ffc28142ec9cb93d1492ed2b8057d0f2b12fee,0xb171de2e4394a97e11638110d96cbb31894c5ed01c12fab29b6b57be09c1cd2f65379b081257b12528229cd71794ae3f
555,1150,125026,114101557,4,4075,32114101557,32000000000,0x0ea7901cf74840d4699d6d4f19361693cddec229,0xb1b4955d2f85a02940b0ecb76a3fc4e1e018125d4fb8780ed62bb76025097b722616f6107eb879c4f3e4f452899a34d4
,1151,125005,113987431,2,3818,32113987431,32000000000,0x8d6b61de69358cca25fef4b7f583bf3ca95a373f,0x8e1ca24005d1b63f9e659c1fe022181c0c99217b9a6f975d87bd35788400ab6a5c30d2df82ed85bc7a81208b5975cc69
556,1152,124948,113623493,0,3510,32113623493,32000000000,0x61824c1ac601f6a7dd96989e95d0ad51774b818a,0x8bd8601c8cda2319a8569c688e9d48f8c185025f57a6b0933b12c045797a0abcba67d854e5eb5c69332c8e9c8b60d18e
,1153,125015,113300020,4,3945,32113300020,32000000000,0x9afee97984c8265585356c4cc52159d60d6a510f,0x8bac8cab062df4e8f275346d7534b8eb8e3600fc34ee9373c900cc563e17aa39c16a054680ce47dc70df240d94de5e8e
,1154,125008,112775535,0,3880,32112775535,32000000000,0xc073ab237040f567aa0b479844b17311282198e6,0xaa61ef2a8252772e1736bc1ab66ff55787eb91679732e6809fc949bb63cfaca2fbf470564b081b8a9e1f7a825e87fc5a
557,1155,124997,112233044,2,3816,32112233044,32000000000,0xb57b87054daaad1750b2cb02951a8dfd14d4e537,0xa9e325bf4746c8d1a62221adbe19c9f5e04e571d7081ae00abf8126a3c2c8eaaeddaf0668594fbae8ffe529abeff1c87
,1156,124750,112039689,1,2351,32112039689,32000000000,0x0c02d5c64f40fcfe10bf65ee900598b6bf9f8ded,0x9279d3f2077928270a76e137795044c4e8b25113eaa55d891a04e0741b8073d14a1b35c931d1376564ce4fae2c6ab69b
,1157,124749,111978546,2,2350,32111978546,32000000000,0x0c02d5c64f40fcfe10bf65ee900598b6bf9f8ded,0x80f8f39f183fef4e936c0088e77d253bc7708b22b70d57eb44b7eb02b69f2c517c0cb122914279dd5dcefe8478763937
558,1158,125098,111360112,6,4393,32111360112,32000000000,0x98c4de9071b49df9ae5d6eaf3e65fcf9f6683b90,0xacbb8d484327d5c7032282ae3cc9736e5f7f35c35a0991ca9d6e4eca4331ab9d54606325244fd7aa2788fda7f184cf10
559,1159,125020,111111818,2,4073,32111111818,32000000000,0x772bf5d823ddff5a06cd9c45b810eb95867288c6,0xb3ba6d8a3f5371732b64aac86cafc8512108ddf696659be464c34780370e4cdf728a95e15c3f3b31a0e138d7f402e1d3
560,1160,124851,111054542,1,2860,32111054542,32000000000,0x473f6f11d2755e93d486f4954cb61aa88a3b3c0d,0xa9d435556f39ce5cf0f233c1dcc4104f9922f7b0d467d4a2764210afd0360c4d15a60784849ab62b7e2b302b90dc323c
561,1161,124904,110891444,0,3499,32110891444,32000000000,0x37c8d33f2162f321a0c9921e64804277e3583fa6,0x87c0e8d5697b3444a0585f7439cee0212d91376d3dd4b9e786f2bb30045a049393aa61ffe2ca45a69706a3e9100d34ff
,1162,125006,110845030,0,3818,32110845030,32000000000,0x8d6b61de69358cca25fef4b7f583bf3ca95a373f,0x8e84751e4da7b13befc5a230dfc5e344bbcc6194311337599c798499235e97954de1f10f12670b199e8161d58d5e1837
,1163,125060,110616021,4,4265,32110616021,32000000000,0xc407d40ae029ad0b3471b52aaf48ee735810328e,0x95d24f9ac23e2d7455418a5dfce0ca0d8ca822930e167068e6c386b46f0c3e7fd5e38d451948fc1c068c54f3a58691f5
,1164,125024,110414311,2,4074,32110414311,32000000000,0x0ea7901cf74840d4699d6d4f19361693cddec229,0xa32b0835a83ac2ef743e080b7a8be62ec605c541e611b27d9c1418d4993127f7ac29110a1e59f84daf68d53ef5c24a1a
562,1165,125108,109860293,10,4455,32109860293,32000000000,0x7268a5e71941e27287debc07274d29638aad3e05,0x8b958fe843a01326476d90b68c7cd0df2903c9859936121301b067a3506921516ab30dbdf3b7f4e51c52f684a35475b7
563,1166,124684,109790227,4,2088,32109790227,32000000000,0x894492e1ccb49cfd159e756e4066ff1efda33bfc,0xa648e415f7e6170032655d1c82d6d7fb63a362e036a400c2ba1068a27b8c07c58843b1f54e7cf2939ec94eddb0092ebf
,1167,125021,108420878,0,4073,32108420878,32000000000,0x772bf5d823ddff5a06cd9c45b810eb95867288c6,0x8f5c036ccfa4733940e04f121bf1d4d025f83655f2f1faa2f577dfc276f69250a7d8a99c709703077b86d8dd5adc1860
,1168,125022,107936043,0,4074,32107936043,32000000000,0x772bf5d823ddff5a06cd9c45b810eb95867288c6,0xa463e1dd9314ea615048df682d15221d5c98415f4dda5232b50646cc4cdef98b4ada8f9a817349a400d80468d3cd2506
564,1169,125035,107352675,0,4077,32107352675,32000000000,0x73c918383c9b2e2bff3780fca80b6129f174c484,0xb5e761df35fb8d80ee9ec29b60ea78f6aba010fd69a6eb7f5fdda8fd5079a3c048fafc54e51f5ad64a100d66e14b1831
565,1170,125111,107108211,4,4521,32107108211,32000000000,0xf5eab63287d3824612079536c6e9cce53e84fc39,0xb24fb84a7377827dd02cd49681168b732c778dab6e2bf03bfa92af5197965954d88aff1ac0cc0fa5bc836e9d2949a203
,1171,125099,106645770,4,4393,32106645770,32000000000,0x98c4de9071b49df9ae5d6eaf3e65fcf9f6683b90,0xb71ac74d4114e65c0e002ce023f53b9bed72f56eb259af5d4444897cd3fcf82234a0f3d02b1e9f72d4ecc03f1a9b21be
566,1172,125050,106591835,2,4262,32106591835,32000000000,0x4af1e8a7ed5b21afa5806e89a7347db2c14b2a7e,0x924baab102466d6bc095f31b2c788e6b1d6208b36d7f78ede871ea06887b817c848cdb9f674b2a5c324f4e690d24daf9
,1173,125048,106257001,2,4262,32106257001,32000000000,0x9af8c16a29af0b8a7caf139b1e5e14c387579742,0x95792feae503ba635f4d9d14ac37910d2589da00f73b01df33515f1addc16dfea0b4780b630adee1f2a95f46d3f257a8
567,1174,123781,105844754,0,0,32109762621,32003917867,0x51457a6ef13fd7e043a83d297c95aaba04419e49,0x92c6dc4aa95a471f104aed3310eb6b01409c9cb13136efd3c5be222b8e44a0c4e564810670926fcb52c8f886def38466
,1175,125059,105691435,2,4264,32105691435,32000000000,0xc407d40ae029ad0b3471b52aaf48ee735810328e,0xaa053c6fc9c348724bac0e6c7bae2361cd8cb28506b1f2ef56bd978f2ce5293cc24448b1a8507145f72315541b8638c9
568,1176,124051,104900682,1,166,32104900682,32000000000,0x9d47faf24a4681acb247ebd11af8c3660a0e100b,0xa52dad01943de5771d07bdc6c8d95d2863b6be48fc68aea7553c948108e73678fe2b0ee28b3312841da67015fdf67190
569,1177,124804,104782061,3,2730,32104782061,32000000000,0x0990dc90c40d498955459ae9acfcee3cb0d7803a,0x99533152ce9041966cb8047985b370cf709273ad78173e03b57419a3ed182da1a1c2ebea3a0cb2fe639c4d0287273ab1
,1178,124057,104644907,1,167,32104644907,32000000000,0x51457a6ef13fd7e043a83d297c95aaba04419e49,0xabc928b5499b837b700d49d01eb2087d4dbe709c0ac52395016f487e471432a92079131136cef8c302d02a163e5c3b58
,1179,124806,104596276,4,2730,32104596276,32000000000,0x0990dc90c40d498955459ae9acfcee3cb0d7803a,0x8adb64612df4a8a916a99997bfc477c87d6ee8a341cf5261ebf8116eb3f39d32c5af5f6155a621aed36cf396ab930076
570,1180,125045,104069672,0,4137,32104069672,32000000000,0x7ba359314cb2888e0b4f435f2822ded258b362f2,0xaca975efd6a89c50402a3eed033123861b874722d2c48df6b1e326cdbe980c708f0bc82a247d60cec4bc8ebc2f8faeb3
571,1181,123831,103814865,4,0,32106110038,32002295173,0xfe36015cda4d3fb0d5f28125e9bc5462e3a749c9,0xb13c230b3af90f03b4a621d9e2e2201d7e227f13eb9a671148eebd39f7c5482e6ba63793442f4f216c4bebb44867c3f2
572,1182,125054,103761918,0,4263,32103761918,32000000000,0xcbf85cc60dd1b22e08300ce48308493b80a35aaf,0x884a483c008c019579cb79243658eaa4bbe652ad4efa3aea70b687c0d7798a1430b679f13afe49dc03b3fc6cfd79da0a
573,1183,124795,103677320,2,2605,32103677320,32000000000,0x34305831ed24335104aef37c16d51c997a257ac9,0xa3842f1c0d08594af8f4c3d1c1846654316004fb75c2fd5c6323ce5153be4a9f8336fdd5121f7879b8d18aa06d13973a
,1184,125051,103231816,0,4262,32103231816,32000000000,0x4af1e8a7ed5b21afa5806e89a7347db2c14b2a7e,0x8a971d23d15c77474a94fb16bcadfd6526c57bcadd96aac83252a3fba784b66ca418cd103a7291f86ac66c406ec8b786
,1185,124803,101497522,1,2730,32101497522,32000000000,0x0990dc90c40d498955459ae9acfcee3cb0d7803a,0xa7724bb9ccfa9bb04248c34de29cf5c42e6acec0ef179c87842744d0a1dac80c3e8c4bb6c27c9ce7c744f619690605cd
574,1186,123467,101405364,3,0,32105694594,32004289230,0x6778ea81ab6cec9e0c0c069561232768b1cd802b,0x81b2b64c28b4fa0bcd31a7fd171d68abc78c9db063c6a6f58a3347bf3f9d828682b11cb97f530accd6939d777f164aae
,1187,123217,101248661,1,0,32113077336,32011828675,0xfe36015cda4d3fb0d5f28125e9bc5462e3a749c9,0x8f43b9182c1f8e867d33dafc5deeb8c34bc111e6aea8aafcde66c18cac9887354d9db130b033a4bb4ab8c27e910eb8f9
575,1188,125090,100670911,2,4333,32100670911,32000000000,0x7edef8594a201f8a17b7d85fefccf8973a99244b,0xb1404560ccfdd97c158ee78f84e5acdca0c036c50b577fd1b09d86aed7232e87f8b7f13b5eaa14852f2af11c5e2af53c
,1189,124796,100388071,2,2605,32100388071,32000000000,0x34305831ed24335104aef37c16d51c997a257ac9,0x83522029157402009f151ee43215a5edf65d7d257f54c07750012d81d4562d05bd978b8637276b76e3f305335e6cc036
,1190,125039,100249458,4,4135,32100249458,32000000000,0x37c8d33f2162f321a0c9921e64804277e3583fa6,0xb30ed479a6a487df5882eca31edd6c8149b0485e2e8e98bf29bd8a9b77d353d401e127d19bdcf7434791e0d9424ff1d0
,1191,125091,100249072,0,4333,32100249072,32000000000,0x7ba359314cb2888e0b4f435f2822ded258b362f2,0x82ea613ebd92f56564aae6051e04362bee223add1384a69efb72a3da90ca669c22b9654133551ddb750b9b94b6e989b5
,1192,125102,100011025,0,4394,32100011025,32000000000,0xb57b87054daaad1750b2cb02951a8dfd14d4e537,0x949961e313c67368b35d1aafd6b9d4ac72082d1e427ca0987258c9a6bbbaa243b5945f0e040ed85a890329ab2d84ca27
,1193,125069,99547919,2,4267,32099547919,32000000000,0x7268a5e71941e27287debc07274d29638aad3e05,0x928df5eea2b1754ff25baaabd8380bb6dd8b5f38bc9fa1d40d8c05a36b8eb7ab9f0c4cf77f6a5a027badd3b477908a7a
576,1194,124172,99006559,1,426,32099006559,32000000000,0xebddaec2a4f611962645ec42511828af99eb9b05,0x8aaf1f3d5dfc69e0c643b5639b77331e015c87a76458a67038857fea2c546d26c9d0325d48965210f59438101f00fae2
,1195,124807,98600488,0,2731,32098600488,32000000000,0x0990dc90c40d498955459ae9acfcee3cb0d7803a,0x878cc7f890de57d063c3b27d2ff366a40ab79a5a9642ac9e0765590298d0781654a2764917977a5457dbaf29aa2343b9
,1196,125112,98538681,2,4521,32098538681,32000000000,0xf5eab63287d3824612079536c6e9cce53e84fc39,0x89bc80e44d40b50d322d42946e6533cd440a6c79a2d5d88e531af8d8f33e8b0327b6e39abdc059f2cbd4080d46f1dbc3
,1197,125037,98066760,2,4135,32098066760,32000000000,0x37c8d33f2162f321a0c9921e64804277e3583fa6,0xb573b73f7a000fcbad934bfc3e13c9818f5688be5bf607fd9124dbefa95547ef8ab9292cbbea3e732af6473158739ca2
,1198,125124,97904710,4,4710,32097904710,32000000000,0x98ada00c2a47509bfc852c188a668a4ef25009e6,0xb7f994db9c07a6343d91f7d00091e0262fba151b0393f03bd71b3d680b1557f258f45688ee59d759aa32a34573ae3ae9
,1199,124151,97689411,1,421,32097689411,32000000000,0x9d47faf24a4681acb247ebd11af8c3660a0e100b,0xb611b7584bfad7489c9096addd38e6cb9a9796444a03b18be358b4fcc9456cc89df7dcc071e7f80c15cd4d48bae222d0
577,1200,124544,96926640,4,1290,32096926640,32000000000,0xd0633946396c83febd50f27298c19c99200ace7f,0xa6c48e07865c4ab40e7ee05ab061d0afb3f51f5e1bf0b30dcfd87eac6b4e1fe21ac89e238d0cf85fe307ea7b81627c07
,1201,124048,96877602,0,165,32096877602,32000000000,0x7f362b0f7207bb6c133f0b86c2e9f004a892f91c,0x96151dc69686d613b62ae2e892973de0fd76e2ac2bf92bdaf8e122932b24b2913fa46e98a268a9b0cfea70922e5d944d
,1202,125128,96709605,2,4711,32096709605,32000000000,0x98ada00c2a47509bfc852c188a668a4ef25009e6,0x94a1a9683fc6f72f7825d5d608aaf0af47a9da378079e76d42613016913aea65d75187f5a2d2a50a6adb221ecacf780d
,1203,124233,95368696,2,625,32095368696,32000000000,0x9d47faf24a4681acb247ebd11af8c3660a0e100b,0xb59d811b9cc621dea8370a0283824bc179ecabed0f41bee4eb040e6a88bdf1e07e0e56cb6bdd475b88e33bfb98a81b6e
578,1204,123084,95303653,1,0,32102978652,32007674999,0x45fd562136301806ceba92065dd9f9e5e333c542,0xb91635ea9c941df10bb39b4088eb12d682f90cd9dd966d9229b73b5fb6bdcc5abe635e6747c70e3c253cbf238c7dd906
579,1205,124843,95097604,1,2858,32095097604,32000000000,0x4c7832f93c17d15e49d12f7e54271a4a68d8ff16,0xa7bc695f24752fdd9a313dc5e3f31d16196145effc7415f5148c3a81665e47279d618443d43675999005219567b18bfc
,1206,124124,95040263,1,295,32095040263,32000000000,0x957d007b3371b2587ea8fecd85dd7dee8008e461,0x865437528cc1800c36fb04de1b43b1625108cfc3eb3ebc3fcd93237d47d99c6eafbc55d87c528e03ffe2d05fba5b5d47
,1207,125129,94949079,2,4712,32094949079,32000000000,0x7732267110d7c852ccf1756e33228c9185f122cd,0x8ddb40d9694fd850cf116d2297d673c5601e8983c709c110d75a19aab47c2eefc020e289c75af523ae54a285c5d2a199
,1208,124769,94816093,1,2475,32094816093,32000000000,0x4c7832f93c17d15e49d12f7e54271a4a68d8ff16,0x86ecd1e5d1dbc5a5820fc926bae143cf8378e312a522d21a9b83e0037ba2b0cd7d43f694d41bb252275bc154cbce2154
,1209,123707,94742825,1,0,32099145759,32004402934,0x45fd562136301806ceba92065dd9f9e5e333c542,0x906ba0695e7a2243e0d3d801105cdfab0da16c548370f1470cfd6a88a6d807d8a1059cfd3b9aad023bfda2f91135f0d1
,1210,125125,94502115,2,4711,32094502115,32000000000,0x98ada00c2a47509bfc852c188a668a4ef25009e6,0xb5ffb25e304d01f806048fe566defb287a448161d9399cba18a9582ea349b5164c89c7480a3404f8756eeb0f50ad2642
,1211,125127,94281065,2,4711,32094281065,32000000000,0x98ada00c2a47509bfc852c188a668a4ef25009e6,0x83d22505fc4f889095661337e242b8573d66dec1bbad6b20012278c5f2c10abc294b84b986a7e2176404a21b79ec350e
580,1212,125101,92993575,0,4394,32092993575,32000000000,0x1f0efa4d02856bd5726c2ea95cc29f5ea39c4a49,0x960bb8fdff7b07aae46f27dcbe43c012d30a791d79eccb4e45e41121f85186e6a55b32fdad78f2cc241b3877a3d54aae
,1213,124223,92790665,1,622,32092790665,32000000000,0x9d47faf24a4681acb247ebd11af8c3660a0e100b,0xb1004d4099902abaca2f11ab35fcbc4ab7ccc206ea94e732602d801af08cd862e555c6cd48bae44e4b6bc56b76c6199d
,1214,125120,92511238,2,4583,32092511238,32000000000,0xfd804e940951f1a204b1c41d3cff450bbbef69c6,0xa51274289355f930b204d4c4782838aff955aadff0563943fa87637c5227f115e1970bd9a5e52e6992d2ab2787d5a45d
581,1215,125117,92318660,0,4583,32092318660,32000000000,0x95ca716e372d70f49039b50e2d98ad90a484a0eb,0x97e3a976fec408d7182a42b1eaa778fb8deb58b01acf5eba43d0096152de9c77d630b1d9a6a7305ad1cf10e53a85a347
,1216,125061,91864752,0,4265,32091864752,32000000000,0x8fc668c95c1980e8d1a91734382e0b39204adaf5,0x9630e56a37118d96dad1f75ae10abc811d3b70f2e69df7331c00c6b8f6cab3125261de28c707fd1aaa9026f1ea364316
,1217,125131,91742755,0,4712,32091742755,32000000000,0x7732267110d7c852ccf1756e33228c9185f122cd,0x8fb99c6634b45b5cb935405347357863e67116c59dabd4fb8fbab43a9810aca224b3c229d4999f81215e3993322365c5
,1218,125130,91698025,0,4712,32091698025,32000000000,0x7732267110d7c852ccf1756e33228c9185f122cd,0x9285fee3ee480c3e91d098a866350a7ca911c2bd994f1831e6fdd41d29293adb6dc790fd72fc1d8419a6af75a7610169
,1219,123469,91379068,0,0,32095539620,32004160552,0x6778ea81ab6cec9e0c0c069561232768b1cd802b,0xb86786e8c5a7795545a6e9609344e505f4eef4196cb47ee7d07f52a56fe78c5c009e72f114894c55a4187dbac477e7d0
582,1220,123729,91328689,1,0,32095500591,32004171902,0xab82da12a7ea7568b8a23c742e988606d256d91d,0x98dfbdbb7a8ee4d6c3e9f19ea2e04b4069cd21b3b7bba18a2fe00b0d7c746e462298c49a2718b2d6e5afee72eb6dfe4e
,1221,125126,91321715,0,4711,32091321715,32000000000,0x98ada00c2a47509bfc852c188a668a4ef25009e6,0x8100c440f1bc1cfd6e56abaf843fdc346854072ef9875c63729571f7927d4b3e730212fb186b19822fa89d068c51df7e
,1222,125123,91319556,0,4710,32091319556,32000000000,0x98ada00c2a47509bfc852c188a668a4ef25009e6,0xa4edb067d6811eda5b06da1293d9320cace6122468fbc41c569939f0d25c13b683d4e6261dc3531cccac3df4d677167a
,1223,124550,91242495,0,1318,32091242495,32000000000,0xd0633946396c83febd50f27298c19c99200ace7f,0x9786b7571407762cf277057c224933ad3f86d69941658c4e3ee50bb711be79e1c9cc194358ba3721aa42d9416b029321
,1224,124764,90479491,5,2474,32090479491,32000000000,0x8d8b9d2e5577ad98d7e57ce866418756151b6301,0xa4f226141252eb7140c62b5e88d6cc6e6ee7a04d9ec467f9391929d1e73996a9654c3fee11c0865900790867de3eedbf
,1225,123728,88510898,1,0,32095969163,32007458265,0xab82da12a7ea7568b8a23c742e988606d256d91d,0x8fafe995c32d572ce5d33522578dce6e74e34ae2b5b6050cd9e00d93951c7aa29e9b0782903b06d45edf00bd0489b18f
583,1226,123506,84071189,1,0,32089491310,32005420121,0xfd700fb59d188f5b6e1919e590069c8f745025a3,0xaca15b7ff76667592c1a12052adc9ddc631a19fddc09338096f297d60229ac6e4b809ef7e27fab7707255c444cbb671c
,1227,123510,83703620,2,0,32089180378,32005476758,0xfd700fb59d188f5b6e1919e590069c8f745025a3,0x9679baeff2cf5390784665f7e0657741d803252a4146972807d00f1e596ab601b8bfbcd3957deab078c67fe0e4d4af9f
,1228,125133,82705790,0,4713,32082705790,32000000000,0xef1a0c4f9608d99cc17a63409e322439516198b1,0xa5ecd46e8492284318fec12b301ec0b55aeb384ecef07376ce5101e40a7244609c85b29e6fff47f16df64f1cfd95f30c
,1229,125132,81345952,0,4712,32081345952,32000000000,0xef1a0c4f9608d99cc17a63409e322439516198b1,0xb9f9697b87fe069dd4c807a3c5bbaf2df5e0bc59aec3ffc5a6fec5680a7fd7e110ea77b851a392f8eff7aec6ecf51046
,1230,124917,79450083,5,3502,32079450083,32000000000,0x8d8b9d2e5577ad98d7e57ce866418756151b6301,0x905a3e03360e9c11b96bf93c7cb697dba7ec86c7a41a883002614bd6f8a17ba889d5d860587e43959f90856ad61c288c
,1231,123731,79092431,0,0,32075256598,31996164167,0x18569525e58d508eb186dc68328a8ef18e627fd0,0xa84d4f734ac9f6a1abba910d88be604656e7edb92d2cbaf7889b1e2740dd639ef591be855abea0b9b65c54fd6109136d
584,1232,124695,78329135,0,2091,32078329135,32000000000,0xd907c2ffe350def88826ecca1ccf1e756aab117c,0x92a1bb8bfeb9e7e3a17160595acc04d3ee34c49bf272c98665fade2531a829625170ece678f66d2aa83911e5663d5fc0
585,1233,124862,76900319,2,2988,32076900319,32000000000,0x0aa65daa49b0395503742a912fedeef06f2cc7a4,0x8eaf1daaeb0f48632c0e88248fc1015942fe6495bdb544035a6965158ca1c4b7f8065e72c73aec76b211d6487d775769
,1234,124154,72292914,1,421,32072292914,32000000000,0xfd700fb59d188f5b6e1919e590069c8f745025a3,0xae039c9e66eabfaa95b5ee3f33d23235210204a3c39a71e9cfe45f5be1b518fae1df0c245245321ab58489c6af25237f
586,1235,123299,69612357,1,0,32068093944,31998481587,0x6c33c7f394496038ecdd84bb66857d91f28f65a5,0xa2d2bab75442fe77ac4dcf0c83151594f83b51627414b9ae445b0e0610915978453b65dd0381f33138549320402f5fb3
,1236,124153,69311766,0,421,32069311766,32000000000,0xfd700fb59d188f5b6e1919e590069c8f745025a3,0x961eb03c798ac03879e7108e48f797b279c3733c52fb525013b7d50f44e1c0b9a88cfc8230d69c340c7b2f6b11a51405
,1237,124907,68513322,0,3499,32068513322,32000000000,0x0aa65daa49b0395503742a912fedeef06f2cc7a4,0x94b89b26c11c6534573dc5d62207b4fdb7e80d86d407c34a0c277063133e00a6274043a006c8c8e180279d7b5f451a23
587,1238,124708,67564242,0,2157,32067564242,32000000000,0xde3ca1a8a1750aa77e0e2bd5f66e4bbc1d13a069,0x80c61cd0ea19282d586c97719eb514cf67a16884b504ba23437de34dee61138d38d554e44ed109b752344b17022077e7
,1239,124709,67467345,0,2157,32067467345,32000000000,0xde3ca1a8a1750aa77e0e2bd5f66e4bbc1d13a069,0x97dc148780fc00693abac4f5f6cd98cbfd56edb9e6cee17ed1e4206389b9d1355cdbb948a48db1a0424ed7082604423a
588,1240,124908,67205221,0,3500,32067205221,32000000000,0x4553993453fc63415cbfa772de0e0ae703598320,0xb426d59a4ea26b63d1d64063222db2c3e3678e40c276d0ee458499b7e6851eb4e3e603001cfa3ea1a7f44fcdecaad410
,1241,123986,67026481,0,38,32067026481,32000000000,0xf90ba291fca4b527e5e8ac1d908f3f5f58dcab60,0x816fef5ae7bd924dc58630826ab0d3397e3a261ec39d5245c7253148dae9de3415412cd8df431f709df272ba9c036760
,1242,124933,65744564,2,3506,32065744564,32000000000,0x8d8b9d2e5577ad98d7e57ce866418756151b6301,0xa49d63fcdda8a91b3c6e3fd94f9aaf2965e17f5d3c913a2e44696add4c84ff88e33d37b0d6e74fd39e5b264eac04acef
,1243,124028,64805506,0,48,32064805506,32000000000,0x6c33c7f394496038ecdd84bb66857d91f28f65a5,0xb6c3901e317c94e74dc00e18717ea8880ba2ddf900a6b1285da24f9a86ddd90b6dbf188cc52c437b6911db4f93a25501
589,1244,125032,64265027,5,4076,32064265027,32000000000,0x1c47ee81674fd46255f93705486d4af26981c0af,0xb54d82ae3a8e7ab5af1684b658033ffb605dd257afa2f4d0e63afd30d6633afae3677325ea6d85598cb6ecb534dab7ab
,1245,124922,62723705,4,3503,32062723705,32000000000,0x8d8b9d2e5577ad98d7e57ce866418756151b6301,0xa41352022f2a92401b9f294fe74ddc0e237d20dfa990bd3181c9fa4c685b512f87f66ee16e9e326273968cce1722b077
,1246,124931,61760709,4,3505,32061760709,32000000000,0x8d8b9d2e5577ad98d7e57ce866418756151b6301,0x8a45dc396978de2929bb228c068fd4832309cdfbf2066f783916390721326a2d86521465b371909eec183a042478b589
,1247,123898,61555607,0,0,32063329633,32001774026,0x7fbed642b42830104533b6851be1b010ff8dbe96,0x8babaeb7d2bdafe7412aaa49a3e042f987e84cdf6e5001179bc817cf51d8652cdb3f75fe0c433d6bc84a7f57796f4048
,1248,124934,60298341,2,3506,32060298341,32000000000,0x8d8b9d2e5577ad98d7e57ce866418756151b6301,0x957abd175b52b8721adc8c918575854480a605bf617b1f140cc4693685d19c501296dc2df1010f18ff852112e8a52a70
590,1249,123735,58134126,6,0,32054322896,31996188770,0x3166abaab4f557c518d8e2c98c4e11b7fdf2a8a3,0x8ac4943e7111235b8b8a9cec66739bb76251aaa5ac0f3eea033f4752a8dc00f3712d5bc0abddb9cbbbe0e748183acea2
,1250,124924,57557438,0,3504,32057557438,32000000000,0x8d8b9d2e5577ad98d7e57ce866418756151b6301,0x8e84d30aac0de4e9b4d23d80df04033ac5c4842c459d24f7dab7c8679067d9248871021cc2b7de52f63c87cf63e2ce07
,1251,124926,57322175,0,3504,32057322175,32000000000,0x8d8b9d2e5577ad98d7e57ce866418756151b6301,0xab8c4d9b4a8e641074e145c8804842def2da218715163967efb7adc2114f3258febebb04a4186100c3133eaaf9384640
,1252,124935,57214722,0,3506,32057214722,32000000000,0x8d8b9d2e5577ad98d7e57ce866418756151b6301,0xa184e2c52468937aa8e54ab8c5fab23804b239c29317f1eb390153cf418ebde14f01be2351f5e0df5f75a0caefe58fb3
,1253,124937,57197032,0,3507,32057197032,32000000000,0x8d8b9d2e5577ad98d7e57ce866418756151b6301,0xa3c571d8a9d7ec215a288f5c8a3f9037aea6089bdce12a7ad9ecc24de2cfd5149941d2a6f6db0da362f7272c311098b2
,1254,124938,56820697,0,3507,32056820697,32000000000,0x8d8b9d2e5577ad98d7e57ce866418756151b6301,0x8e2177be5c78a369a81be62f509a860fac25ff431dca4422aad5e638bca055c3cebf44a3dbae2a3f5a204201a19e240a
,1255,124927,56230953,0,3504,32056230953,32000000000,0x8d8b9d2e5577ad98d7e57ce866418756151b6301,0x8053bdbfca0268111f625f1e4c5c8a7e5b81e9c7923de9c7956e329b69e6692aaa3aa834e760ed51f721d8ffa61c6cfa
,1256,124919,56108965,0,3502,32056108965,32000000000,0x8d8b9d2e5577ad98d7e57ce866418756151b6301,0xa2ce5126964c39e3f13118e4074adef09c95674092c1f52f8a611dc3e5b67159c18e9f86a0e39d61ced7c2c41620b382
,1257,124960,55959116,0,3513,32055959116,32000000000,0x6fe09034941ac88126f416098b45917a0c9e3906,0xafced66a0b4e987d217cb943f70a44afab74a31d966bdd660d93c49a75cbf999a6c0a9093a1a4e62b7be83829ff3430c
591,1258,124915,54947257,0,3501,32054947257,32000000000,0xf9952584a98fb8cceec07ce6990f96a1751bd21e,0x8d7cb105b0f4b3dc2c23d1773e2e2dcac22b12686c3826f2e9e48157eb456599be3e43eae3ad66d5ac34676d174bbb99
,1259,124963,54742999,0,3563,32054742999,32000000000,0x6fe09034941ac88126f416098b45917a0c9e3906,0x855fcf359b3bc685df9e232967a448a4538e396d77dca93460282c2fc99a4c9fa93b4b03ead4b3db6305cb78d2acf35f
,1260,124961,54698905,0,3563,32054698905,32000000000,0x6fe09034941ac88126f416098b45917a0c9e3906,0xabe9cb88f908252d5638511f91fcee6b974f07fbfe710ddb00b67837405d1adc0723f8bf7a804e31169f720f32fcfdb6
592,1261,124754,54496496,2,2352,32054496496,32000000000,0xc93b87addf1ae76bf2db982718e1c1a812b20450,0x80729725fc62e552611058b0490e0e14171ee5b16f8b3c3ddb690b2a4beb7826244b31955aaf0c641e671d8c4d075c72
,1262,124962,54444880,0,3563,32054444880,32000000000,0x6fe09034941ac88126f416098b45917a0c9e3906,0x984ea36d41e979d56c2be5559ec8d5a17ab0858507bdcb202254b02b859ca27dbc896ee6100781b114d9d08846055d69
,1263,124701,53406191,1,2155,32053406191,32000000000,0x9d47faf24a4681acb247ebd11af8c3660a0e100b,0xb47082fd7947c4a05f1964efeb969a13db2c1f732ec8207b9854da83112e894c785d5ff6d266bc2aec6c10989ecca113
593,1264,124912,50674389,0,3501,32050674389,32000000000,0x86d86bb4cda860d4a26279f51d4761f507a3cb3b,0x937c43d86590d130b5f0d6c0bf7884858514ed1fc06d5eb8e1404f22868c184cc949d975167a43007b4d7d8931e75277
,1265,124702,50346626,0,2155,32050346626,32000000000,0x9d47faf24a4681acb247ebd11af8c3660a0e100b,0xb9005acbdb59bd6e1e3b1c06054199338ba878f02ba482b98eae83e91939b31602251c66ce3f7dcac79d81b08b29ff48
,1266,123523,46903314,0,0,32041787627,31994884313,0xc7ffc28142ec9cb93d1492ed2b8057d0f2b12fee,0x809144441673f93e70547f13d58cbf2d63f509cec31f297924bf81008aa1d5031d0175c5ab890abbe15b89887d027d5a
594,1267,123391,39068088,0,0,32038861590,31999793502,0x915d327bc8d9ae9905f7dee4a335141916a5969f,0xaab589d6b8582c0d98901c46a88151278ebdcbb3c73e2f291c7f9ea98fe5d3f89c66b80b3c751fe47cc6762e06bf8efd
,1268,124021,37634410,0,47,32037634410,32000000000,0x915d327bc8d9ae9905f7dee4a335141916a5969f,0x8812e08408c7b0930190972691977bc333b92c30c132608ba9a1b4f8e6e8961fbb4436526c1226e9d226d27f684c47af
595,1269,123812,37297347,1,0,32039568676,32002271329,0x95745048f92c99fb02e7580bc750616246ab3af9,0xa62043e6b929dbbb16a334649a642d88579a6a11052950e54d220105f72590b686b053ef5d801c8f1c4f02def7c82f38
,1270,124164,36072676,0,424,32036072676,32000000000,0x75c8c9e5c64e9830814446d3b20b71ce3d19a21e,0x91402adb47042e3fd6172c43fffc9f6d625af0e219ee811f28da5260a4e5cf1a9e08a634940b9af82aa75555b2b3934b
,1271,124167,35966215,0,425,32035966215,32000000000,0x75c8c9e5c64e9830814446d3b20b71ce3d19a21e,0x9260205bb4ec35ad57bcfd3944bd9679cefbd4b367315be4890fe3baf431aba547378c2f1b07a69f1787fcbb4a4b90cb
596,1272,123973,35528473,1,35,32035528473,32000000000,0x2fde5306e60a115a5f1a5b55d5b0c37b5c86603c,0x8199f8054d0282c1fc016ebef2b34554ead1e331860a966627702316d5574c6239e7b706e27faa757f0308b5bb1b574e
,1273,124964,34255854,0,3563,32034255854,32000000000,0x9af8c16a29af0b8a7caf139b1e5e14c387579742,0xa52ca25b1426ffcd029c401741aff46edcd12838898da4a08efd6adef9f797f76f59df757933e8b220dd106def29eaa4
597,1274,125047,32288062,0,4137,32032288062,32000000000,0xc1106f5faa02c6c6b87b11f6d6a41bf164841212,0x8b960cc232429237cefdd56cdbda5b982be4a5268872d78947a4e5fa11e4a2f8b1132cbf82d3c5c48faf57a37975f8c7
,1275,124360,29414327,0,1005,32029414327,32000000000,0x520eb411a4c2db1950d0ef33e3e1355d00d24692,0x9854a1b36a0e7987840c2c0bedc50f18d3905a54546b4bd1f723bb3cba2b2cec41606b1e0cb86ca1eab2e073f97f78fb
598,1276,123603,27974812,0,0,32032899952,32004925140,0x296b0b8ee6015f82ea8afcf078d505a945cf4c00,0x94f58a395bcc703fc3bebeeb4b538bd0b9971e5183f98f917de3956c7a138248b42c29c60fbe5b5ee7d1b1f519ddd2a9
599,1277,124858,24873200,1,2987,32024873200,32000000000,0x83a2d302467cb4552875d9e3e7d3f630d882e72b,0xaaad488dabb0d1f57f35dc126c680fc86099c3c507a640387632e5e489852ae38bd70427ac5f5f0040c9a48d6a65c866
,1278,124105,24816555,0,291,32024816555,32000000000,0xfd804e940951f1a204b1c41d3cff450bbbef69c6,0xaedffb542bf4c06e37d3aaa263c22269a48e34bac57714f0cb8149751404ae1b71d00faa87751283574daf1a461a26de
,1279,124869,20123508,0,3051,32020123508,32000000000,0x83a2d302467cb4552875d9e3e7d3f630d882e72b,0xa1bddf4869f3b3df4c271af428ae87768a98724c60ecefba7724fc92c9f2042199a5e9e7b2eaa1b5413fc10872036f45
,1280,123072,19032278,0,0,32026761842,32007729564,0x75c8c9e5c64e9830814446d3b20b71ce3d19a21e,0x885e4b5f2f247ce9dce2c8a54fd54bbd43b27294391a7e992995670f4283135cb95281d893d5cf3e4d58511d80f997de
600,1281,124791,18403083,0,2604,32018403083,32000000000,0x6ef8744993d4c4042d7e07ac8948f486b26405a2,0xb38b3a414fb8127d1fe2f9bf43a41636d326cae7a8cc2bca26644da10090dc4ce28f9d8dc29832a0403e8f2d1c0fc92c
601,1282,123068,17078551,0,0,32023410874,32006332323,0x97717e020d7b1dc535fa7e954b7c730444d90625,0x8adce43fc7d27ecd694b5035160cc3bf79b7a76205b228e083dc634d0e4cc9de22a3f5f752054111e376cb1370dfa45b
602,1283,123860,16260184,0,0,32018274726,32002014542,0x70b6ee2317871c898f060552e040e9b135ec7743,0x8635a5c84f967ea04420e81f5b47c6139f14e449f5c97e9c7227ac428db82d9216be7e245bbd52309ddedec074d2fede
,1284,123387,16220963,0,0,32022441672,32006220709,0x70b6ee2317871c898f060552e040e9b135ec7743,0xa0e23fb4973fb6f0cf56ef5b7899bb0c858d4373098403fa3952e56775f76d933b3d7bbc0f48ba41525e139ba64cd3d9
603,1285,124207,15844346,0,556,32015844346,32000000000,0xbe78e47fb1b3b25cf10ec22168ae659e31c7838f,0xa5108a7311fee7b551811b267ca2fd3b02e95b315a82bb0864511484dc554b6a5f58ddcf15c4751054d6a208d4341c4c
,1286,124988,14128471,1,3751,32014128471,32000000000,0x9d47faf24a4681acb247ebd11af8c3660a0e100b,0xa9249ebf6dc423956ffe4a2d1e65ce1a8276db6f21d0bb518b76200533848b4664003ba7f9c5d80a2ec5a8832b54b332
,1287,124952,13909483,0,3511,32013909483,32000000000,0x772bf5d823ddff5a06cd9c45b810eb95867288c6,0xa24989f7531e230b7ba7c7847ce37271b7fbe25649a8564cb0926324f685657ddd2844023cf73d30fd4cc7d61fa239c3
,1288,124677,13799139,0,1966,32013799139,32000000000,0x724e42e83c36f5e23102fa8ec6352b6b121b8777,0xaf77170462b31b9e6cf12ba01bea97e650546bae3790b465e695149bf8311dc987e5a8c728f39f4f6019d6a05a356a14
604,1289,124579,13571426,0,1582,32013571426,32000000000,0x9aeb02d0996f01e45cfb99ba5570422f0028f7f4,0x8e51f51e7a2d05347c271c62fb06087a1d7ad7e581d879dfca4ab4880cfb1c70ba0e68c29e5b6b8342d25f0d12c96a84
,1290,123925,13065010,0,0,32014661732,32001596722,0x6993aff5aadf101de3ca2076b8ca19d8784ec9ce,0xa630ccf445c00d2a69a6837f08db8f0e74ad35bee23626a96a4774813d2bc345d3caa1910f8307d2407d9c9c8f4cadbc
605,1291,123829,12238780,0,0,32017615376,32005376596,0x460c3b91b84e77544b35bfeaa544f962c730a6d9,0x86477725b44ed91723cbd65b266f1b6fd99191271d018f6c5a6f6abffc442f66995f6289accd708d1302a3a61a59f206
606,1292,123528,11834137,3,0,32017262728,32005428591,0x2dd3209803823592830199428781cf7c98c3a74c,0x95cbe326571b4b03e3580f0e9b76092bf10f800b6e0f0b58833f35a09f353974756a58b2e188b6b0b0be03f5d42376fc
,1293,124347,11259389,0,942,32011259389,32000000000,0x9aeb02d0996f01e45cfb99ba5570422f0028f7f4,0xad499cd23c1829960e9808d36dd8c89a3b739f771d364ba168d4f146d44712394342b22ebe2cee774ad1555cab4052ac
607,1294,125002,11200291,0,3817,32011200291,32000000000,0xdb3f1ecf6ad96b10dee6e0255d269d5d5c6fe1b4,0x97a9d0db91f940cb5a57515802fd79a98fd748a0e62b81ea884e3d24e64f7f637ea9dbadf952232b1b7061356dd4a41c
,1295,124987,11170844,0,3751,32011170844,32000000000,0x9d47faf24a4681acb247ebd11af8c3660a0e100b,0xb6d927067a08168b14f53ae692b66b8da448de66787a48f5f456bcbf5e6a2d8f864049938c4a6c79cf47896ccbc50c7d
,1296,123526,9582921,1,0,32014939360,32005356439,0x2dd3209803823592830199428781cf7c98c3a74c,0xaeb989f2e04e1ad4b5d93f154cf33cbe418ed8c8eb104adaacde81109dc4047f1e7ee7d32b8804a17d7fecd9ad1740d9
,1297,125038,8641133,0,4135,32008641133,32000000000,0xdb3f1ecf6ad96b10dee6e0255d269d5d5c6fe1b4,0xaf3d7aeee14a61c46224ac80607b5c4116fa269292d5158c49c7abcae65b4e3f2995eaa8cca181a314e5938986197a20
608,1298,123433,7551557,1,0,32013336575,32005785018,0x1181fd0c501d2ac88a32385c060f255249234422,0x96f462399b33f833e8533c2ab5e129ef7e47cfa85a8ea1c911b5296a63a63c0068d0debaf8ae6fdf7c55311907e6adba
,1299,123918,5519195,0,0,32007124687,32001605492,0x1181fd0c501d2ac88a32385c060f255249234422,0x9029e51350237c0fee562987f7c1c98415e4807dbdb3b11124aed1dd5e90fdd814e42c0d649f0d88b564b834575bf935
609,1300,125025,5430231,0,4074,32005430231,32000000000,0x09e0ff17c840b8fe663b555199a570a3b0d86911,0xa1a72b48971e2c0d8f65a55ca760c75a939fff9798b0f3d497e0db3593ebdc2dbe137762ae5a271bed95e1ba18032a41
610,1301,123772,2921803,1,0,32004060579,32001138776,0x343788aa9046e0dc7485f4239b704e47304b89f1,0xb230e6d226a2287350b811357067090d8215d468368e5726c38623e2cb5d07ea642b65f7a8a52832bc2f3a3f7693b120
611,1302,121421,0,0,0,32027453800,32027453800,0x10d3447ce9d69a28d32f5c6445ed484c047a3598,0xb193534a575bb0818596005a9ba2439d273771cce9086e61673e46ad0df3cf62e3c95136bf4fb7395d3504dd64bcfd9c
,1303,121423,0,0,0,32013680972,32013680972,0xb6d59f7c2e6f884f2ece7951e24107da5dddb4f9,0x8113042fd772d60ce4a41b3be91d86ae654e6661bfd409e9846488c64bca90228aaa9ce69b5fbf293bec4d3829dbf039
,1304,123066,0,0,0,31999580086,31999580086,0x9d47faf24a4681acb247ebd11af8c3660a0e100b,0xa7b693bbf5ea66a4035ad0c2201dfa3a37817c8c585024bcce7393b96031143b44aef9b28c50e2c5389f817d4831962b
612,1305,103863,0,0,0,64348792602,64348792602,0xdaedeb8d897ef7a2c5f3b0411574c31cc0f6f010,0x9962d9f622fba9c71577eebb57dd2bcb6ffa6e479a1898380358dc9d823b888375c0be91eea81009e2d9826eb69c3c93
,1306,103866,0,0,0,64334975577,64334975577,0xdaedeb8d897ef7a2c5f3b0411574c31cc0f6f010,0xaeb1d9042f8fc51c80bc1aadc575a7766c09d9e06bcd3722367be534245da0a0f592269a1ec2e56152f6e52d9b86fd29
613,1307,105306,0,0,0,64314045191,64314045191,0x19a6b4a63e1a45535014cf36e23dd291ac0955fd,0x88451689ab13ccf3cd8ba1c3894d0004d7c34454004f2c495924bca591d097c61e00bb5e32bd0c147623c481fe3e0096
,1308,105307,0,0,0,64316050319,64316050319,0x19a6b4a63e1a45535014cf36e23dd291ac0955fd,0xae41b2f7377751ea0df106d68c8257a97e7c06bc963161e3cdd9721cf8085c630284b5eeab9ad864dd253640070bbbc3
614,1309,105386,0,0,0,64373807043,64373807043,0xde88d54819c4ae692fbb8f5f914ac5723951ee65,0xb9676278428d923824b4bd8a1f6033b4e8365d47b31c0d8c56d3e706863b2291abe65fba2b0490c179517942f18daaab
615,1310,117791,0,0,0,64024504398,64024504398,0x4046318c1aea6a1c172b7b5052d1e112b11ea1dc,0xb8b5aaa0683f1fba10db43ff018fa1e95b22360abef11415a7185442d1e02b168a68cc1b35c7ddadf3db374d308080c1
,1311,117810,0,0,0,64021637219,64021637219,0x4046318c1aea6a1c172b7b5052d1e112b11ea1dc,0x99671eaf0598da6caab79c3a36839f806efc2e9825a16553a74df18754ec04f9fb46510a23f85e6d99b6293fca1735f9
,1312,117811,0,0,0,64021358787,64021358787,0x4046318c1aea6a1c172b7b5052d1e112b11ea1dc,0xa07cf239a6e379363caca57d4a49b9ea4888354bdc56210efa3d7a251d7a9a066c9074c601a0351eea1ddb490c3dc58d
,1313,117812,0,0,0,64024689660,64024689660,0x4046318c1aea6a1c172b7b5052d1e112b11ea1dc,0x91116e7a82c7f8095ab073455467de077673494b77cf791d2d5ad55248925aec61e9b80e7b681b40fc79e22142be50c2
,1314,117813,0,0,0,64021985337,64021985337,0x4046318c1aea6a1c172b7b5052d1e112b11ea1dc,0xb58628337c7417a09085b0859a905329cb50d2215f6019772dbce86e51f8e20f71c6abd31e92ad4be56fb78c97b4390d
,1315,117814,0,0,0,64021772416,64021772416,0x4046318c1aea6a1c172b7b5052d1e112b11ea1dc,0xa027c1cf8b44bb3dbe89cc26b8b49eb8f555db6f4180201fe4dbb3de3da69e6d6eb70d092603fc81a7747a76eab08414
,1316,117815,0,0,0,64021787851,64021787851,0x4046318c1aea6a1c172b7b5052d1e112b11ea1dc,0x8dc15f6f233741ce9de1b9aebc4723d885fe86b118dc727681972666ee0e63abf34765fe857afd72dd0ad8f15ad9b717
,1317,117816,0,0,0,64021695255,64021695255,0x4046318c1aea6a1c172b7b5052d1e112b11ea1dc,0x938fc15b929f73ae897ee25bc88cd3c32f58e98c6515209c2b4c32c4a10d8b0abdaf1b96fc3977d827f97d9f3e0ca206
,1318,117817,0,0,0,64021691493,64021691493,0x4046318c1aea6a1c172b7b5052d1e112b11ea1dc,0x85b51617c8367cbacd5276dc578b4b811e65d3912a2e3a6a71ed468b7dbd97faf200be3558e1efb8cc9dc0e552aac7e1
616,1319,104085,0,0,0,64404007385,64404007385,0xf272511c002d0e04e6abe43311c03c637d92df6a,0xa7ed8919d38b135ad071b7b9bac49b303c8611d0aced13bcca0202d20bd0df03aebccc93674679eae52dd8a11a9bdcc2
,1320,104090,0,0,0,64390713987,64390713987,0xf272511c002d0e04e6abe43311c03c637d92df6a,0xab324548557aff7d28a6ed5e30a3d9ebf6d4a45f5dbe559bf6a80a764b158643a7d31b458f14aa7d6e5e13b9eb9f3980
617,1321,104056,0,0,0,64407463828,64407463828,0xb33082c124ce4f949356362393c0575d01239e32,0x8c53c8d8b3d53f4f61d3b156201954fe699d3f61f3703c067e034b07040f8b758fb78a417e7e852d58877a0286df4d61
618,1322,104225,0,0,0,64366931871,64366931871,0x5d2f836cad056c3bd19ba7f2f4bba75ded8c2bda,0x98331caadc7b4249a0f90b4fe68061d98c6ddf0cbd5cb428cb873040c86da176743e72dbc23a3eea4e8e9f88c6f627a9
,1323,105571,0,0,0,64366356596,64366356596,0x5d2f836cad056c3bd19ba7f2f4bba75ded8c2bda,0xb0151f1affe91120844e09e6b85555c30982d868a0944980ce77a57f9f2f78b5b0889d25f7f75330a724440985d31514
619,1324,106067,0,0,0,64363486356,64363486356,0x24e4a0f781f1a00e902e1aac0c47f8d62056d32e,0x8d9e5eec322a7ded618fad7ca3e32f4960d69c2c9951fce8991cdf91313b5139a5021c306d9a22095d69746baf503a79
,1325,106100,0,0,0,64339527747,64339527747,0x24e4a0f781f1a00e902e1aac0c47f8d62056d32e,0x9272eb57f16f241aac75e7ab1a22396260da1f82f6d2623a131b0e0768efdb71cd1a72269462bd32cac5dfe3cdefe28f
620,1326,113250,0,0,0,63961501215,31961501215,0x1fbeae04138db4b28cec91f7b7861d82544c819c,0x90f5bb369116049e79997bb61b5a8f4a94dc705b4f4006459ac5dda06e6686b47181b3153a033e66dbeeed74b8e0ec13
621,1327,123183,-2801382,0,0,31989679612,31992480994,0xdddc84ba59c337234d262afc95032c0c51545f54,0xaa9107add063f2c67ca4f923c62f7c6cb56dccec882105dcf5974c4952dc6c87875b434d088cc1fa6cea375c977a126f
,1328,123644,-2801382,0,0,31992846053,31995647435,0xdddc84ba59c337234d262afc95032c0c51545f54,0x9172529bc67323e4e2bf9900bd11f3981c8856a5d09244dc00fe7d65e990f33e2de5f416c3213b359e3dd84d46418149
622,1329,123094,-3961664,1,0,32003658637,32007620301,0xd1d134cd5a062934ac653e5dc2bae93115a410bf,0xa34db87654cd4c33361f57494493a2dad1358f2c4158b57de9a2b68537d1c6f8f4dd61e48b4c687cd92c9ed61d263b66
,1330,123509,-4258247,1,0,32001223480,32005481727,0xd1d134cd5a062934ac653e5dc2bae93115a410bf,0x82da82ef9f5c61e75b6dc48ddce60f5d26015aca0fb2f0476990a62164fbee5fa9d04fad8998c92dd20cd5bc39083132
,1331,123517,-4500079,0,0,31990359610,31994859689,0xc7ffc28142ec9cb93d1492ed2b8057d0f2b12fee,0x82dd256880ce330f1c792ae6b2a7b8b442c4067d8603c64c5983f7cf7f0aa071664fe3ad491c6a9efb5879be42685e67
,1332,125058,-18878818,0,4264,31981121182,32000000000,0x45fd562136301806ceba92065dd9f9e5e333c542,0x8cdbcd4b778775d2e7510cef0ce6ae724edaf1eab036865079bb0187d9de84f6fda1e4c3da2bdf67bef4292a8ad1a995
623,1333,124848,-19523944,2,2859,31980476056,32000000000,0xc4ed31d88e62e0a4bea1d08ee7f332eb7ddfd88b,0xb17fee88f77831e457e04a1d29ec01d87e788452c391f85a85ca2d78035bfa32204bd8c70b9c4099d1f0ce99f88097f9
624,1334,125040,-20217803,0,4136,31979782197,32000000000,0x82fe3766ff5d885ee2b6f9fc9211a4d694315ff9,0xabf759f43c427c959009fef4ad5b2f594e3c8765f79585ae3f7978fb33072f74031e0ec9d8898abde1888513f8e61268
,1335,124176,-21967635,0,548,31978032365,32000000000,0xd1d134cd5a062934ac653e5dc2bae93115a410bf,0x91319f2e0acf3534f44ced633aded095291cef8d099be2828c770734a68863d9a7eb9a188ef7f6f8513120ce7d254752
,1336,124264,-24478716,0,805,31975521284,32000000000,0xd1d134cd5a062934ac653e5dc2bae93115a410bf,0x87ace760558442098fdcb660edb04351ec26f052f23a6c813c882288475fc6e58cc53812cc490dd866613ca283478a4a
625,1337,124395,-25462762,6,1124,31974537238,32000000000,0x9cd77af98f34266e7d8ed95d196c1d7583f3edad,0xa3680db46a7ec9117375176f806fcae497d8765b4a73ed2ccca21e53795cbcc31545b7cf932891c8e29a1f85be17b6e9
,1338,124753,-30996863,0,2351,31969003137,32000000000,0xc93b87addf1ae76bf2db982718e1c1a812b20450,0x8b00bb8ea416ccae7b2f3162b02e6ecf0fb87c6312e15dbee70499a4aee534e79ff5eca7262fa9297b9ca43dfe2f0b96
,1339,124396,-34591514,0,1124,31965408486,32000000000,0x9cd77af98f34266e7d8ed95d196c1d7583f3edad,0x8cec23a17d26fa3db7e6f24dfd9eb0db15aa96223e84230c6505c2d25ba1ffb0555ee37c765c21530a8195d1c485d3f4
626,1340,125065,-34733617,2,4266,31965266383,32000000000,0xd4ebab81c2e3cd7ff537ffc5e4d2921c6488ccfb,0xaa66862328a110668d67be1d54e4171017bebcb4ff24a7809cc0eb907195a5e1e460ced9f91f57db68125dcd4f5beb5a
,1341,125057,-37725616,0,4264,31962274384,32000000000,0xd4ebab81c2e3cd7ff537ffc5e4d2921c6488ccfb,0x818dcf0dd3209ebe0f4974e20d87fd47afd79c1385bcc0a82225dc3f19b9fee9f01fedc6ea68539551cd454e33875765
627,1342,124913,-47288860,0,3501,31952711140,32000000000,0x43c5112cce8d7f70412f0ad867a01273699b5add,0xaedb67e186dcbe0d787f4ead6b039ada16f3b4c49d0052ca261f1a9874241d5c50af4f120ef6a9aa6d8de1862b82857f
,1343,124914,-47594960,0,3501,31952405040,32000000000,0x43c5112cce8d7f70412f0ad867a01273699b5add,0xa3d4a013d954e13da029d8928e135a25c03e830dfe68cd49ea588277cf9a3260172c038daca743bd54e7099650fbc048
628,1344,124410,-49249699,1,1256,31950750301,32000000000,0x4aab8a785b7db6fc8074d5cd2749aba340a671d5,0x8461b2c0aec68d1adc6fd3307e12f1cbce2e85e426b7238d9e73c092614953030f9b6fbf2dbd87cf45381297c76883e6
629,1345,123602,-50994695,2,0,31944381996,31995376691,0x4491effb348d6ba8e3dc4680bec797633037098d,0x929980dacb637a6dae7e27276cf49edd19d08e89c6758299a17f2378f0761681b5cfbe6f4562ab2be67163949bb85dc2
,1346,124685,-57589377,0,2088,31942410623,32000000000,0xd1d134cd5a062934ac653e5dc2bae93115a410bf,0x8bde8609724b087ec462c938c53274b75d2fc00c4315cb4da13dfffdfa29b7ba57d4282ba07c1c750ce6f2f1fba7fc2d
630,1347,123849,-57767110,0,0,31940290999,31998058109,0x8f49cb80a0f32cd69677885752aeee038c88662b,0xa2f369e3b3ea9854ef47adbd78e27c15ba14d069756d6ad49546db73884a7c16e57e23719971f8aa0f8b7477005a0f52
631,1348,124599,-64053529,0,1704,31935946471,32000000000,0xe01020d4b5f836f9045a22e3a0a8e8a2624ad48f,0x8434df6e39c15ed77abc56e87609ac94b49b7c3ca909ddff1852464e54adbc808254a8703ab3b7d53fd19d55d596c4a8
632,1349,124570,-64571358,0,1579,31935428642,32000000000,0x22b8424eb899147a699e4bb177013bf264c9ed85,0xa7c3591af3a64dd470e7ada5ecf0d2df4b8c6e6b6b4375822877d3ff04e35ecbbb68c7c089f66749e2c5d43f7e990ad0
,1350,124571,-64601759,0,1580,31935398241,32000000000,0x22b8424eb899147a699e4bb177013bf264c9ed85,0x85d443c02897c1f13a7f3aeb85c01ad8702b108b3fc49c186ed14ad9aec27ddfde190365b12fb7de6c35e510a450db4a
633,1351,124674,-65539986,1,1965,31934460014,32000000000,0x92e123077cdc6fb97708d4ed4887f773a4be2578,0x97c1b6edff8e7f3bb3001247bd8283a8c9eca214681f7b56ee1bb15da2186d0d9a0c74f7545915cb6a2e404eefb84f49
634,1352,124977,-77277195,0,3686,31922722805,32000000000,0x05c6280b1608d3b95abfd7ec38bba75d28cf6355,0x978a2aa7898d89619da5e87831da9f20e72883d4ce38c63830df552a0fb694410e354bb5e871b3f96bb26b90b0f6392c
,1353,124035,-78355872,1,50,31921644128,32000000000,0x22b8424eb899147a699e4bb177013bf264c9ed85,0x83960dda41445e22d54148d65e696a62a2dc8c71d5564cb25b3e20db20cc7e823ee081097bad155708b5806be6849709
635,1354,123806,-90335615,0,0,31912103285,32002438900,0x23ca077b8b3820935d3b93a7d692f67e0fc317d8,0xb150eda4dfd1253cc487c6ff3800df433078fa8a2870d5b348c82a4596a81e30e503637ae2b75908f6edcf2a714168ab
,1355,124278,-94397893,1,808,31905602107,32000000000,0x92e123077cdc6fb97708d4ed4887f773a4be2578,0x84e1b7414607ae138a65f98d62d5c984379c3c994ca1312d77cd4a4e0032a0f4bf871662d13207f720f65c39e7ab1328
,1356,124353,-99454038,1,943,31900545962,32000000000,0x8f49cb80a0f32cd69677885752aeee038c88662b,0x8594bb71fb55de579132dc4017f99a43a35903beb65285854b3b6cf76828b06310034b22fa7c369a305bfb168de3a61a
,1357,121429,-118332211,0,0,31886353799,32004686010,0x97717e020d7b1dc535fa7e954b7c730444d90625,0xb1185106fb966bc6ebf76be1c9e4a40efc720755c6ca4599319a0a4a0e55bf58b234c9d833de3a718a6865dc6375f9f1
636,1358,124394,-118768356,0,1072,31881231644,32000000000,0x157ebf59cc21e5c6ce79ff334c748278dff26c62,0xb342c30d76133281eee00ee9c839846ab8932e5b14545dc8306101065eb5baac280bc82e821ad76a8072ced825720552
637,1359,124108,-123590565,1,291,31876409435,32000000000,0x6e2d6515d75fa5234f3067ef81ac03b7ead65cb0,0xa712fdc9171d74d2cc4d5a5c1582d02a8488de21cf599d463ef1c827266309f82247de73f8d6a92245f289ad29b36959
,1360,123971,-123802512,0,34,31876197488,32000000000,0x460c3b91b84e77544b35bfeaa544f962c730a6d9,0x9676d3173ec467ea209766e69f1106f6ad5372a39948bd9e65c5e1812d37ef31b6155f3cd46422a617bcc279d392597c
638,1361,124872,-125055900,0,3115,31874944100,32000000000,0x430202a0b7bcd6dd068e77c72ed72120ebf69181,0xaceeeec8191355796ca317907189debaecbe3d824995d88795580e75537a5ccb669c16302408bdd0b3c3c1542e5316cd
639,1362,124261,-129463936,1,685,31870536064,32000000000,0x2068cc70f8841bbbac4b2b6f942bd89593bf80d4,0xad054e6a6f354f21f44db62cb6b355ca1ed9afdd0a58d943b3adcb91234c4ccc6edf8a2bef7a0d7180ff3ecbc491465c
640,1363,124847,-131328156,0,2859,31868671844,32000000000,0xcb4c1ac5eeb42766e013406fafb846894391781b,0xaa0802ee5cea42592654cfb79d1e99f74c1f03438814ac926d2f2309b33f6052619bdd146402b7de6195c241a3c23ed7
641,1364,124239,-131546169,0,680,31868453831,32000000000,0x02c6f6cd74b5dae786b49167b777a579f4029032,0x8cf616e7bc99c0918ee2445018e8bcb702b7c5b6a213e534d17d63234da7bc703bf8dcd95369568a703d69d0663269f1
642,1365,124675,-133680761,0,1965,31866319239,32000000000,0x1902f0f363df8bf3c320fcbba7b701804ed91cf1,0xb27b43b2c2ea7cdcfce90df8baef28f74dbe2f7608bf913a038c6a117aff4c69c29d726d5400f0d7904d7c38e382a67f
643,1366,123899,-136323184,0,0,31862868022,31999191206,0x5be1f8163d2138d4e4d5870359d4b381462b01fe,0xb1243d5c0bba88b9afd1902ee1c6a879a8d45b6a3a8ca011c4edaae7f016f28c8531507091e864c0462b72c488296504
,1367,124181,-136796079,0,549,31863203921,32000000000,0x6e2d6515d75fa5234f3067ef81ac03b7ead65cb0,0x8d5146fa3cbf4fa275a2960c0c48871280d1683da71a8f54ade012e80665dd320833f3a3c1ff576a0f013f8fb09bcf16
644,1368,124798,-137528022,0,2606,31862471978,32000000000,0x5ea6b99a26bb20ff9ebcf11369269f691405076f,0x918112a3a44e50263b6ddd919dba9cb22f88b5ef61c37a7735b0c7e344da602467d0c4d1c632e4a6711fb58162436d7f
,1369,124799,-137528022,0,2606,31862471978,32000000000,0x5ea6b99a26bb20ff9ebcf11369269f691405076f,0xaeca559a5f6d1be665e10347b54eb893e988204ff4fc6c7a154a88a95b713b51a5e1e56d62a7e5131eafbc730a3a390c
645,1370,124548,-138645588,1,1317,31861354412,32000000000,0x416a2dce2dafab5946bd33f927fa325f7a9419a6,0x853d3fbc0cd8a0c54cbf5b4789a315be940030359718f79de38e8e1168990f738137dd306d8a3d8e1e21b43abf5f794b
,1371,124293,-140350219,1,812,31859649781,32000000000,0x6e2d6515d75fa5234f3067ef81ac03b7ead65cb0,0x8f687eb08480a5982416342c5c59040df2f44b5f8adc863db62fcf6e6e556929f8cb80f1f46068b6e7a8ad294da380bd
,1372,123996,-140415233,0,40,31859584767,32000000000,0x2068cc70f8841bbbac4b2b6f942bd89593bf80d4,0x80cea5ffd3d0f01e66f926e2b4c587f06173592c3be390fe794ed3ae1a1c0af5b7cc8412e0a941fd7be1699ac04d43c8
,1373,124547,-142589392,0,1317,31857410608,32000000000,0x416a2dce2dafab5946bd33f927fa325f7a9419a6,0x85e91284a6b851d1654c335c7ef3b123634e1333b8bbde0d05258795c4e6e7a2e7dbe76a9e0316d9f5b8c2b7c447ee17
646,1374,123706,-144948289,0,0,31859312414,32004260703,0x9a979f2762938ee7c4bc4b88273f0c894693af80,0x98dbd77b378e250bf85651b13dde6b58568312ba3d6672560c2aaa77776be9bd68345dc5c71c34cca175ebf6538b56b2
647,1375,124717,-145493013,0,2281,31854506987,32000000000,0x50b9268d27a2cffb909f09281e0e516029d9bbe0,0xaa38e27a1011d4354d21777d260b985a7ff45e33a06f630e705467bece715bedda5e1cb72d58f54aa6b2c8ac4eb475a4
648,1376,124713,-145517526,0,2280,31854482474,32000000000,0xfee49c60fb37e088bed83420525b3d7069146f09,0x956932358349f8f037681a618cf5cd09c7e6e0582708e692cb94b1ab3bc29d30634fc07f95c3fff947dba61ae7b59403
,1377,124121,-152947428,0,295,31847052572,32000000000,0x9a979f2762938ee7c4bc4b88273f0c894693af80,0xa33a7a43bf3b7617ff2f5b1f4e044dfda06b8e41cbb96127727928d709d793017b880cf78633804aecdcb17531456f10
649,1378,124672,-153239211,0,1965,31846760789,32000000000,0x68a1cc20472f0557427a56d8522de13787350e65,0x94b80d43b210639fe768758d54e407793e60470c7681e541725000b7a8737e329fe6452df871ef91e04442e4efe6c8de
,1379,124673,-153239211,0,1965,31846760789,32000000000,0x68a1cc20472f0557427a56d8522de13787350e65,0x92004aa9b3afd1ac9fd1350179e8884de796293cb504182ef70e607299bd079f804d078ea361a8c54299eda5d3aa4616
650,1380,123474,-154188297,0,0,31851484266,32005672563,0x5e3200a7bd0444a85ea1d35e4471bcdc96d0ad38,0xb4aee221103058fdc26e2b3c1ca3050957faa104c8fa1243351329d18e8031210ae654b69904bc5f94195e5554816430
,1381,123990,-155283533,0,39,31844716467,32000000000,0x5e3200a7bd0444a85ea1d35e4471bcdc96d0ad38,0xb7380dd915ae92510c42c207ffb008ee89ce7de06bd00c66d344d208dde49cbcd0bd656ba0011bc3cecfc895d0d751b3
,1382,124635,-156451005,0,1834,31843548995,32000000000,0xcb4c1ac5eeb42766e013406fafb846894391781b,0xa75d99879b54acfe0d5235c5040d71d3c9102d49da0cb6c704c050d853628d93717709ffbe1f466ce3f0e3b4d4e6c4f1
,1383,124636,-156451005,0,1834,31843548995,32000000000,0xcb4c1ac5eeb42766e013406fafb846894391781b,0x99d375b736ebee0b31abdb13bfe989d2e80090563ab9ffd60089f0417fe887152cb8268afb877101ccda99c3926138b6
651,1384,123568,-156892903,0,0,31848211067,32005103970,0x1f2b92fe1928e820aa100dba1a63dd37decd08f1,0x9821e07b2d1b195f20bd02336cdb6fc3812eea3bddd86e5b923bf3fdb36aeb38544bdb67ae49ee45a074e4c2327c412f
,1385,123462,-157049090,0,0,31848581115,32005630205,0x1f2b92fe1928e820aa100dba1a63dd37decd08f1,0x8cc02688c959dd79c36afa4b54c4e14b8cb37eef882d02e825fb5436ac82604beff9c049a9d27d636d9c28775b73f226
652,1386,124557,-159273785,0,1385,31840726215,32000000000,0x48cdae0b1133cbdeaafcf276ff0709b39ba116a7,0x91be4e09b317b5a33788ae8a99412cb79549af8c7a22675283b60bf6c945c89a913697a4bf4c7c74a771f07bbece9064
653,1387,124605,-159613956,0,1705,31840386044,32000000000,0xc05c06dfee6ee09e9b66dec933ff09811618c53a,0xaa5162bfa6073f79f6314e9a0f90cc4284d660c44b886f2ddaaa76c9a75ee2aa7ccceaa1da8d1201cb63fb610027193e
654,1388,123380,-164327077,0,0,31841817071,32006144148,0x80f5c42f1f07dc228f377fcc0db34b7df76c45b8,0x8a3663a3bfc1c62ae1ce9d413aa53db024665a95c57e48d798d6edc52e570f67f521f2e224e40723c73c2cd13bceb992
,1389,123378,-164363434,0,0,31841827659,32006191093,0x80f5c42f1f07dc228f377fcc0db34b7df76c45b8,0xac2a902071fe44563e6f565e4e5aa17eb2e882a7cbf8b19502573a370cadb4070aa78e7f47d3e63444a7cb6b16f8c6c1
655,1390,124184,-164737060,0,550,31835262940,32000000000,0x8e89d6845faea90042811beb3b6b91a86f897a00,0xa728fbaae4d8d20e1ef641898916f16883093f0840a179e76667d7b7d2966e9983e00e2444f1c77aba985d70fa4403fb
656,1391,123854,-165978508,0,0,31836122585,32002101093,0x4ad17c83a075d1e8703192d5ab295b499206730c,0x9944a3864dd74b303b1c560b84c441728d7c754353be86d1d1e7d492b3e6dc8db5a160b7d9038bd9c148951699319d60
,1392,123866,-166117354,0,0,31839173127,32005290481,0x4ad17c83a075d1e8703192d5ab295b499206730c,0xa21a8c767f980e3b6999cecb40c231c87b3bb15b2c9e94b12598e5c9dc51c13f5949b7c320c7d569595ef7e0795e4418
657,1393,124232,-186206347,0,624,31813793653,32000000000,0x411e951022fcdadde9ac550f5b05e66b5c0231c4,0x8ec86f38a8760d1a01656305a84b83285fba869239d2ce99c3abed8b0d18567e644a8441bd9e21e9bebd9de59c919f99
658,1394,124226,-186230902,0,623,31813769098,32000000000,0x1a7d8c9911a3e715d0b008d75e888b807025ac60,0x8beec6b134ebbe3e7d49a078a5581826f1dd4c17263102bb68eeefb39ba9903690e3a9aa78cba87caa2354ed8272373e
659,1395,124227,-186230902,0,623,31813769098,32000000000,0x781d68fdebe6d1b2b6f9471ccff1241011354c6c,0xa90ec6fa385238f7fb7c1153c6d36273b4a7cbb64a6862a5baf61f68a732f96778bf861460303e0b67871f631ad908db
660,1396,124200,-187959304,0,554,31812040696,32000000000,0xfaea4912ff3a4962cf1d9720691c49a91f3ec0c3,0x9128ca0b7051d8f3b21c99b7870274686cfceae623d885c377657066eba5fa7940c394b10a8158106312e7adb5784279
661,1397,123057,-191167164,0,0,31816716657,32007883821,0xe30215c8a2303e7cd9b8d261af28ad4ea8d750b8,0x8fab65e0c9d2d129f364bd514054dfd59bcfa8ccea9dea5c6484f12bd385f76ead334579fa1fef6fe18836091bc253a8
,1398,123073,-191175347,0,0,31816629278,32007804625,0xe30215c8a2303e7cd9b8d261af28ad4ea8d750b8,0x822b67d7ce5721c41a81649e28fcfdbff17e71d41f7d64b3aee3556ed848c75f3f69c58a7161455146828becb5048017
662,1399,124120,-194345341,0,294,31805654659,32000000000,0xffe116bbad78c6c8e5ac963ad6f29ad6d3cd947a,0xb0396e8eb728a21fdd3ca1230ee97e6ec0be81dd048e81005ef5ab2b6ec542bd11a4d31c5330c1c0ea53c20bd5878a5f
663,1400,124114,-194369905,0,293,31805630095,32000000000,0x253b6149fdaba4f59be036d538ab2a5e604af40d,0xb676d07c995dfde20a7bfa7a0ccc574c7d0e7c8d21945562a1817a21d96f3c10d8fa43ddb33f2b9ac1dc6df7c858b429
664,1401,123405,-201438289,0,0,31803913965,32005352254,0x4a46780d4aef99e97359489dae461d5f1070d090,0x8001fc842fffdfae70b1633ce288c86ca2ab6e3689df2e8db5d7df9129cb427b147556b82a42de6665825337bb7721a2
,1402,123404,-201487382,0,0,31803862266,32005349648,0x4a46780d4aef99e97359489dae461d5f1070d090,0xa4a5852e538c74c9feabaa0efeab6f353b7a6aaad55aa7ca5e3ce7f9ba7b546ef313564204dfda123b8ac32a76fa7c2f
665,1403,105413,-201571405,0,0,63465092562,31666663967,0xef0f4dee906ca4377f8296f4eeb6ee27fb5c684a,0x8a990e3d1c87723c8441ca97ca7b504ca30d7ffc1950f79ea238a4ea01fd4d593ac75522e1e156d00d82b9590a195d06
,1404,123300,-201593677,0,0,31791798436,31993392113,0x10d3447ce9d69a28d32f5c6445ed484c047a3598,0x8ec5fe77df17ad34f7b640340c83d41b9c9fff7e6da01d0cb72a67c9e2bc9adc38367db1796114193eeb3b594b744bc2
666,1405,121544,-201593677,0,0,31813012835,32014606512,0x32359d4e5b9fdec323802635738b29bd9dbbdc43,0xa5edddf6b2953b04be2a90cb116cfe706822f10e035a3c41d70bde1fbc2db4398cd909b282c1de56cea60ded082146a0
,1406,121562,-201593677,0,0,31806594594,32008188271,0x32359d4e5b9fdec323802635738b29bd9dbbdc43,0x8d64aff2d36e89c05834aeff47f8f2956c1eacc8a64d9a6c8f8085b230e25f26c5f66f856e89c0fdaa2a14eb990773f7
,1407,123319,-201593677,0,0,31791897016,31993490693,0x32359d4e5b9fdec323802635738b29bd9dbbdc43,0xaf530a724823f7f3f1e634b39d5f1c47ab4a05421ce3de28420d20e1f49a41a3fc573edbb9442a4464df759bd7620aa0
667,1408,121554,-201593677,0,0,31765361799,31966955476,0x7b74959215ea0ca88a051e0ce1cd1266280073d5,0x99ed324ab7d1a9a7bfdb426c018f99eff8162961fd7e7a5d6ff7169030484c01e56449bd4d8cfc19b490e91347602e5c
668,1409,121555,-201593677,0,0,31813753008,32015346685,0x70c25ed4b8d15d9e5a1209c10caf27a68a6e9ac7,0x8bce00e90057e425571ce9ece011cc2a40634fba8dd7a4a809978812953f9a1b0aae63aff9987cf51ebc59b070d4082b
,1410,123713,-201593677,0,0,31794472078,31996065755,0x70c25ed4b8d15d9e5a1209c10caf27a68a6e9ac7,0x9311906d342ea6a3e6cc858503715cb737ee9e40ce847747ec544fa521e1b712eef236ff44d874fad2e325dc69570ccd
669,1411,121565,-201593677,0,0,31799961633,32001555310,0x9f504fd3cd843e3d03011eb373f20a66c2e7066f,0xa7c444b056bdc96b4b9ec47ed5d18e66c7179ba7998e731cede068da22c64c47fb372d8eddd775410d1c5e9e7a410af1
,1412,123536,-201593677,0,0,31793389123,31994982800,0x9f504fd3cd843e3d03011eb373f20a66c2e7066f,0xaac5f5b913c37362badf5139f4b07a6d72dfde800613d30157fa29e432fc52be3b22f0850fa2ebf866cb45a2f4ddd116
,1413,123538,-201593677,0,0,31793389123,31994982800,0x9f504fd3cd843e3d03011eb373f20a66c2e7066f,0x95dd85885c1396a4575bff5e03daddb973c4a4676a31c92dd79d82390b4029273d95efc203d1a27ea0777a4696059fbc
670,1414,123070,-201593677,0,0,31790196777,31991790454,0xb175f6c17783cfca4ce9553780f8bdda98139301,0x8b7fb1acec3c994ab01043bf290430803906a7300f2278c5f7812809ad0d554f0232f9659f952b4dad44babbbcf81326
671,1415,123078,-201593677,0,0,31790246109,31991839786,0x9db20edd530a66a9f1a23f789942d4478f0a3b94,0xab6c47ed872e290c6ac545f0484ffb40deba6d23ad5927f8a60c0cb70ce1c30a7163ee6d8c752db5d8d9cccc3fd95e0e
,1416,123090,-201593677,0,0,31790320107,31991913784,0x9db20edd530a66a9f1a23f789942d4478f0a3b94,0x81e97a1340f5ddfe45faa0c31102cf3263a7f1844d1f28fbf98f904dffe22dc5b427631152d3f9abf0efa65684f05b81
672,1417,123082,-201593677,0,0,31790270775,31991864452,0x8a047cb2ac6af1758895ae3ad0506ce1b83e357c,0xa030df24f80d7693ac5551bf66766c08219819de7897326b127a49d06dc0105f308d561352d76b29e549deedd5c78467
,1418,123083,-201593677,0,0,31790270775,31991864452,0x8a047cb2ac6af1758895ae3ad0506ce1b83e357c,0x8cea62e2428c4d73d52edf26152b588f16bfa8912abbd215675e3151558c63e48fcb3efb1e5b896b9c673dea2eea82b8
673,1419,123089,-201593677,0,0,31790320107,31991913784,0x986e24b827d4fb9dea617130730753d80ffcfc72,0x89076965c5677f198393de09bd10caa3936f04a4bb46ee9cfa36d487202bde72067633e136bf6e0b38522b0ba40e064c
674,1420,123111,-201593677,0,0,31790443431,31992037108,0x6c443954179115b9ec2e4fcfe559bd8a8f380a5e,0xa735fa9fd56b86dabc2484ae63b09e8616e231946be464290b4d7c6398dda3f410359ec8d5ad57f6d5896459c2eb261d
,1421,123112,-201593677,0,0,31790468094,31992061771,0x6c443954179115b9ec2e4fcfe559bd8a8f380a5e,0xb99d29d1a6d05bd465de1dbb12c3fd3f4f644d15014346cd3c19b1177e50b7160d2c192c7244d6c3c69389ba63a3e5a4
675,1422,103939,-201593677,0,0,63897441295,64099034972,0x969a1f7abd0c9fbd197ccafb8c33fa7d086ab3ef,0x842cd572d31b7795094464c61dc1fd17b6f9b77f78b0dc93acaf8ecc71074f6e0bf315273ec99f425bd421987afac92e
676,1423,123235,-201593677,0,0,31791207828,31992801505,0x5bf60aa6a973aa54f9c1fcd10bb60ebb628d2edc,0xb8d5db12eb1c59ab412c7b6d223fe1fedde7f1a6f63cd8db1dd46ca75f75df9b04fda351af686780b2659abeacac22f3
,1424,123503,-201593677,0,0,31793167516,31994761193,0x5bf60aa6a973aa54f9c1fcd10bb60ebb628d2edc,0xa6988c06ca0d5caa88a2960064beda597b52363505642e5bfc792b8ed3404bdf40b73175fa9ef87793a8ba4ce07810d6
677,1425,123265,-201593677,0,0,31791473476,31993067153,0xc3351a91e460f9ba443897d943b24840070c5231,0xacdf131419425c7a5baeddf5d63698ec073fa8b50196eda3f573eb7f44e23dbcdac49b12a26cb85423fa5be751ac9211
,1426,123266,-201593677,0,0,31791473476,31993067153,0xc3351a91e460f9ba443897d943b24840070c5231,0xab6d10fa8fdcbcf03d7f81114212c4312fb0a5c6fb1d0e0a00cc9830bdee9be9999a2ad3dba0140182a61dd6bbb29469
678,1427,123295,-201593677,0,0,31791714928,31993308605,0x92de4b1a20bcbc4fb82e9e6acf94a3344a9dc07f,0x95ec0de8d28fa49f04caa3e1a5494f9f2aecdf60c12c8b89617b010d0a8ced1eeb7b0228c4377a93e8872a7aa516c057
,1428,123297,-201593677,0,0,31791739573,31993333250,0x92de4b1a20bcbc4fb82e9e6acf94a3344a9dc07f,0x8358f3dcf334ccbbdae543158b15f74b93e5c70d22a4f2dd9f6e1659753c3975bb9757faeb6401321e83f15f09581d8a
679,1429,123298,-201593677,0,0,31791739573,31993333250,0x28f79b0ce55c93bf2f7b2415c8a73bf75dea8de7,0x930e93cfbc6a97f74c31d25f0b494e67413681ff8e8721e96ec1a3d9a3d8134ebfd9185a8c56b83ad6974b612c028669
680,1430,123324,-201593677,0,0,31791980514,31993574191,0x57760655c2fef419da61806d303a713326a6e278,0xa867a7d116478cb8a6634b171cb3c5718abd99332d83127a484e625f2ef875029b8d7a237289cbab6d83cba8574a6350
,1431,123353,-201593677,0,0,31792221907,31993815584,0x4046318c1aea6a1c172b7b5052d1e112b11ea1dc,0xa95f66ff91616360402e5a4f72628f8de76672f9b343a5dfb2b05e5ea0d89130b06e698177cf59843e8df0bd74d8533c
,1432,123354,-201593677,0,0,31792221907,31993815584,0x4046318c1aea6a1c172b7b5052d1e112b11ea1dc,0xa009f581cf79b2dedd9af422707044a05fdb59c944d6f14a530409442ecfddecb3fb7b1ee5d4697def17466861f21a0e
681,1433,123388,-201593677,0,0,31792443649,31994037326,0xfbf3bc2d8647c9c23608e4d0f8886d528008a6d3,0x8f02041c780ff657cf2e91e5f1f0aa1e08fe4c893bac8c3547402d2fcb447062a405a048f399a123f855fcfb2077e2f7
,1434,123389,-201593677,0,0,31792443649,31994037326,0xfbf3bc2d8647c9c23608e4d0f8886d528008a6d3,0x9398c1ec5f094f877a225928622b3b7113754ea8af92c9c90b1c2984c259498e71daea6a47e85414da6b17d77868c38a
682,1435,107180,-201593677,0,0,63735714885,63937308562,0x53561e4062d25d0caf8100783e9da3fbd79bebe1,0xb091fe9cac13febd49552f571a97f5d6314f976727ee7895e8ddddfd959215646e57f04f02c7095fbbc4ae0bdde5e0fd
683,1436,123531,-201593677,0,0,31793339881,31994933558,0x1660fc620d296b704614b82d074bdd22ff90ec2e,0xad91cbec102b9565d93ac9d9f1f1045966c7fce5c0e1758de1fb37cdd5d520c5828ae483a5dc50eb1db559698f08df69
684,1437,123654,-201593677,0,0,31794102976,31995696653,0x9713bf2a5395543009d41417f9a12b4f43bcec68,0xa3e42af1d8bb8b120a7e86f4fa49e204112a38222fc029ba3944ab15822b68e4404922a128230b3eefd4c413e00ae1e3
,1438,123655,-201593677,0,0,31794102976,31995696653,0x9713bf2a5395543009d41417f9a12b4f43bcec68,0x861ce163dc4c27a957aeba34a16239951db4e2c36230412a98a3a7dc2630b4653bc8e33ebf46f9fd7666f66ff61cd3fc
685,1439,123723,-201593677,0,0,31794521284,31996114961,0x15f8aa1cb7487c8af1c9eb075bc62e49e2f4c0e4,0xb533d828a73e75a5438df39e1b7f6fe0b7a7d5c5640e5491dbd912c6930b7a0010dc2b27748c470df99cb7519c90d9f0
686,1440,123724,-201593677,0,0,31794545887,31996139564,0x66593a4202ab4ec67a9b9d23f8839a058ecf894b,0xa5996a52b73e16e11cfa26019f38eee05c8607d2113e485972cf446ceaf5690adc9b4d852d3194a8c0fb025767ced7b7
687,1441,123736,-201593677,0,0,31794619693,31996213370,0xa16460fab0e8b66c6fb2ac0a3eeaff2f35c2ddb6,0x8f34a5b04419cbc90606a4b738837aa86c6dd41c3c52cb1e925ac140d130b13dda6dc706c8adabafae0a112fe6272611
,1442,123737,-201593677,0,0,31794619693,31996213370,0xa16460fab0e8b66c6fb2ac0a3eeaff2f35c2ddb6,0x97b0c6f2b97ae657982851d4c589aca739bf8c9155f624a4154569461d9b15c6e5ffe10689141fb8d073f140bc1e5b5e
688,1443,123872,-201593677,0,0,31796611963,31998205640,0x30f5fdf8a34b31e51a259f66e34be61911fe791f,0x99b9bca1144b0e6c8dc2cb2ba3189cec2c7e8d411bd05d0bb7c3d7feb0a7aefced89a29b2bd497698973134bddaf9e8d
689,1444,123939,-201593677,0,0,31797005314,31998598991,0xa1efc89bc7d5521793f2574c96bee2f1444241b2,0xa87a3525b2b4f0d206f8a75c038e90677faae06a9ed16b784e8b798870753144f6edb4f4d74f4cdb3ac9b2fc76d2af61
690,1445,123947,-201593677,0,0,31797054478,31998648155,0x22ec616840d8a4c9f937918b6c6990e004da6166,0x980297c0eba1c1dda02255bbbf2a0ee0b6b67b9685f3081ca04c9401a48ca6fe6ae19f9d325a946914eed542f9d28635
,1446,123948,-201593677,0,0,31797079057,31998672734,0x22ec616840d8a4c9f937918b6c6990e004da6166,0xa68ef8914fb25ff0a68f6abd4e093e607936656c3fc4164178570ec371b215425d3107739c966a191f9aa1e1155b08e7
691,1447,123952,-201593677,0,0,31797103636,31998697313,0xc7b80146fbd8cff55554da77cbfc32958fbc2c23,0x9963eae22010834c7bbce8bf83093ed94a146ff88a2691397def9b799a2fd269cd97d2d84d127148778460ab1b9ac0d6
692,1448,124733,-272030096,1,2285,31727969904,32000000000,0x1457fc37d2d32d5f9a9bfb9984a80c5b9e654114,0xb034c76da3cb658f7285e3d7ca06d1c7488e6c20de8b8fd9ccee04d84fa72edab80d1a0d60ae54078eb0ab9c2ee65e70
693,1449,125096,-330029294,0,4393,31669970706,32000000000,0x4905f32d6a0f68d25d0cbf337b59611c9b8c80dd,0x866c988bbd6aa05b51340da58ef2774dcf81e3ae5bbd5d5585ba34a24d2960ed3afc23800576063785afb1dbbb372df7
,1450,125097,-330361373,0,4393,31669638627,32000000000,0x4905f32d6a0f68d25d0cbf337b59611c9b8c80dd,0x99d2cf4a25a494dfa770fa0a95a85945f454047174e0bb30a2d4b932cf40e17a318073790b5ecb99f0278fd638f6f26b
,1451,124732,-340833071,0,2285,31659166929,32000000000,0x1457fc37d2d32d5f9a9bfb9984a80c5b9e654114,0xb77d9af0a222dc1a325b7877061df32efe12b7f9a26b060ff8a01e449ee4eeaeaad2a79e3d580e079c6b27ffbb20ef61
694,1452,124760,-367915249,0,2353,31632084751,32000000000,0x91e53ee0c579fa0b6652f5eaaddf1bb23ea6b1ac,0xa86d63acce2b66c6ec4cfe90cb91147aada488b168e5c7e886d57915acd39c67013dc5b7fe5615a63056e8dcc55094af
,1453,124759,-369299440,0,2353,31630700560,32000000000,0x91e53ee0c579fa0b6652f5eaaddf1bb23ea6b1ac,0xa51071f307b3d8119188f59e254630385a195e2af306d677b3d66ecce87a8ecac8717e3b2bf58441225eefea1b9b12c6
695,1454,124729,-378801787,0,2284,31621198213,32000000000,0x9b902ba750afa562891ee66f343138591f1a7494,0xa92a0f5a3976fa222874c08bd280e14f5a25d724d84e81cd9240e5b2cb8377603871d6b9c0d800935e9a41a18a16a4cc
,1455,124730,-381260840,0,2284,31618739160,32000000000,0x9b902ba750afa562891ee66f343138591f1a7494,0x9a003e9d325d2f50e4ee25a12281fd62f3f920832b5362e33edf7d73376d05d9baee949f8c89a312712049b80412b50b
696,1456,124658,-382547671,0,1961,31617452329,32000000000,0x70ccf7ed22a22d975380772107bb36ad6e437967,0x991c8bc010f72c99723ac621ec4adfae9369414021b5b2285e602913bad6d2dc5a6dadac9867af1847ab5582ca468504
697,1457,124656,-384848188,0,1961,31615151812,32000000000,0x783b800161287823a1c964a2cd49356b83085822,0x8e5fb52341b8bdad89c47b4b8da3c102a06d5b2019909facb9b34eba318d07fecd3a5f81ee7096309f1f7084a1d54c6d
,1458,124657,-386022119,0,1961,31613977881,32000000000,0x783b800161287823a1c964a2cd49356b83085822,0xb387613d316792d52c7ca759db0aaf8b157be51bbbd0d855361937fff4eaf4d9f89f8665c8344c8cef8bf07bcba966bd
,1459,124659,-386324230,0,1961,31613675770,32000000000,0x70ccf7ed22a22d975380772107bb36ad6e437967,0xb4102d44259181993e881ab2976a00751017ab77636f5ccf21171878a04ef4f0f3fc5d0872c9423c4d3d5e6ec5930599
698,1460,124631,-386398694,0,1833,31613601306,32000000000,0xb667dd386c39cb2d866dc18f5a7c78cbdcd30a1b,0xb8fc77b2fd4fc8108094b78c8f19a5a4a1098d9a1e4fe8eaf640c9e484987186a56ddf2fd9340b205bdc2eee5e1fbf37
699,1461,124639,-386992047,0,1897,31613007953,32000000000,0x1a9a6837f13136b78e3d15ff65fd30359eb4cf14,0xb415b89057401aebe66dfac9eaec269ee102e615f1be2d84ef384406bf4aa1d92535e45b96442393bc950e64186fc460
,1462,124640,-389391705,0,1897,31610608295,32000000000,0x1a9a6837f13136b78e3d15ff65fd30359eb4cf14,0x87d786ecfc627289c8a62b92b372cfb7ce2844d312ad5fbe7bad5545452e1b179252ba93d5f95d2c7ce218db0544382e
700,1463,124641,-389579737,1,1897,31610420263,32000000000,0x233854c965ae697cf0b1ae2946268d150d4102d9,0x86e10783106fcdcedd773c79d492d3d2ff472cc41e3ef917a5a1216ebe61934c606775b02cacca4d034deb150db6dcef
,1464,124638,-393242390,0,1897,31606757610,32000000000,0x233854c965ae697cf0b1ae2946268d150d4102d9,0xa778c251db5910b430bd438549461a8f5c93e27fd9613de71f22ca9377548ab83b40549b14489ce7cc5bacd314fe6f5c
701,1465,124621,-395718769,0,1709,31604281231,32000000000,0x8e218bd65947130ceb9514a38420941561a22c37,0x865821121fd82df7fda1f95ab09422f123bd9208da313630c85c15f23b737dc3ac1b4f950b947ab6fe6b61e57419e4a4
702,1466,124616,-395758251,0,1708,31604241749,32000000000,0x07d3e91fc7e167d7f6fdbb3fc67d124132e622a8,0xa9dbdbbf440febac195421428271939767060aded053adf81131813e9a6058b11474b8b884ace2f3e0b93faabb157917
703,1467,124628,-395837134,0,1832,31604162866,32000000000,0x1d1dd51a67bde412846952bce6a23470cee0c3d3,0x85ce75d972368ece3d156beaf8f43647220b178b0c31131aa1bcf9c5fff94952d23f79eef550771498faf6118abc019f
,1468,124629,-396520620,0,1832,31603479380,32000000000,0x1d1dd51a67bde412846952bce6a23470cee0c3d3,0xb81344a13cefcc2c6915edeb0f9e7ec172251c661c0d46c3d66917b103f06426e8d9810fe6f2f31468e7943669f9a8c2
,1469,124630,-399783134,0,1832,31600216866,32000000000,0xb667dd386c39cb2d866dc18f5a7c78cbdcd30a1b,0x98a357e6154f0a8885546e5e6a00bc71eeeebd0f40121d9a438b3f39854844bbe16eabe418b8e2829f643db0f621b89e
,1470,124615,-399979196,0,1708,31600020804,32000000000,0x07d3e91fc7e167d7f6fdbb3fc67d124132e622a8,0x906fb8610f6d4ca3bfd32d71469c70603b6541ff0c6c45e3201a462896169ba1f73e711ac8e57b1cf5e422ca522956ed
,1471,124620,-400430937,0,1709,31599569063,32000000000,0x8e218bd65947130ceb9514a38420941561a22c37,0xb9d573e862394d21ae9b1e032723b8d64793b769880116eed85567fe5871d8f46f27020fada2fb3c1495d37e5341bd3e
